-1 -1 -1 -1 -1 -1 -1 -1 -1 -1 -1 -1 -1 -1 -1 -1 -1 -1 -1 -1 -1 -1 -1 -1 -1 -1 -1 -1 -1 -1 -1 -1 -1 -1 -1 -1 -1 -1 -1 -1 -1 -1 -1 -1 -1 -1 -1 -1
-1 -1 -1 -1 -1 -1 -1 -1 -1 -1 -1 -1 -1 -1 2 2 2 2 2 2 2 2 2 2 2 2 2 2 2 2 2 2 2 2 2 2 2 2 2 2 2 2 2 2 2 2 2 -1
-1 -1 -1 -1 -1 -1 -1 -1 -1 -1 -1 -1 -1 -1 2 2 2 2 2 2 2 2 2 2 2 2 2 2 2 2 2 2 2 2 2 2 2 2 2 2 2 2 2 2 2 2 2 -1
-1 -1 -1 -1 -1 -1 -1 -1 -1 -1 -1 -1 -1 -1 2 2 -1 -1 -1 2 2 2 2 2 2 -1 -1 -1 -1 -1 -1 -1 -1 -1 -1 -1 -1 2 2 2 -1 -1 -1 -1 -1 2 2 -1
-1 -1 -1 -1 -1 -1 -1 -1 -1 -1 -1 -1 -1 -1 2 2 -1 2 2 2 2 -1 2 2 2 2 2 2 2 2 2 2 2 2 2 2 2 2 2 2 2 2 2 2 -1 2 2 -1
-1 -1 -1 -1 -1 -1 -1 -1 -1 -1 -1 -1 -1 -1 2 2 -1 2 2 2 2 -1 -1 -1 2 2 2 2 2 2 2 2 2 2 2 2 2 2 2 2 2 2 2 2 -1 2 2 -1
-1 -1 -1 -1 -1 -1 -1 -1 -1 -1 -1 -1 -1 -1 2 2 -1 2 2 2 2 -1 29 29 2 2 2 2 2 2 2 2 2 2 2 2 2 2 29 2 2 2 2 2 -1 2 2 -1
-1 -1 -1 -1 -1 -1 -1 -1 -1 -1 -1 -1 -1 -1 2 2 -1 2 2 2 2 -1 29 29 2 2 2 2 2 2 2 2 2 2 2 2 2 2 29 -1 2 2 2 2 -1 2 2 -1
-1 -1 -1 -1 -1 -1 -1 -1 -1 -1 -1 -1 -1 -1 2 2 -1 2 2 2 2 2 29 -1 -1 2 2 2 2 2 2 2 2 2 2 2 2 2 29 -1 2 2 2 2 -1 2 2 -1
-1 -1 -1 -1 -1 -1 -1 -1 -1 -1 -1 -1 -1 -1 2 2 -1 2 2 2 2 2 29 29 -1 -1 -1 -1 2 2 2 2 -1 -1 -1 -1 2 29 29 -1 2 2 2 2 -1 2 2 -1
-1 -1 -1 -1 -1 -1 -1 -1 -1 -1 -1 -1 -1 -1 2 2 -1 2 2 2 2 2 2 29 29 29 29 -1 29 29 29 29 29 29 29 -1 29 29 29 -1 2 2 2 2 -1 2 2 -1
-1 -1 -1 -1 -1 -1 -1 -1 -1 -1 -1 -1 -1 -1 2 2 -1 2 2 2 2 2 2 2 29 29 29 29 29 29 29 29 29 2 29 29 29 -1 -1 -1 2 2 2 2 -1 2 2 -1
-1 -1 -1 -1 -1 -1 -1 -1 -1 -1 -1 -1 -1 -1 2 2 -1 2 2 2 2 2 2 2 29 29 29 2 29 29 29 29 29 29 2 2 29 29 -1 2 2 2 2 2 2 2 2 -1
-1 1 1 1 1 1 1 1 1 1 1 1 1 -1 2 2 -1 2 2 2 2 2 2 29 29 29 29 29 29 29 29 29 29 29 3 2 2 29 29 2 2 2 2 2 2 2 2 -1
-1 1 1 4 3 4 4 4 1 1 1 1 1 -1 2 2 -1 2 2 2 2 2 29 29 29 29 29 2 2 2 29 2 29 29 29 2 2 2 29 2 2 2 2 2 2 2 2 -1
-1 1 1 4 4 13 3 4 1 1 1 1 1 -1 2 2 2 2 4 4 4 4 29 2 29 2 29 29 29 29 29 29 29 29 29 29 2 2 29 2 2 2 2 2 2 2 2 -1
-1 1 1 1 1 1 1 1 1 1 1 1 1 -1 2 2 2 2 2 2 9 6 29 29 29 29 29 29 29 29 29 29 29 29 2 29 29 2 29 2 2 2 2 2 -1 2 2 -1
-1 1 1 1 1 1 9 6 6 6 6 11 1 2 9 6 6 6 6 6 12 2 29 29 29 29 2 2 29 29 29 29 2 29 2 2 29 2 29 2 2 2 2 2 -1 2 2 -1
-1 6 6 6 6 6 12 1 1 1 1 10 8 6 12 2 2 2 4 4 4 4 29 29 29 29 2 29 29 29 29 29 2 29 2 2 2 2 29 2 2 2 2 2 -1 2 2 -1
-1 1 1 1 1 27 30 30 30 30 26 1 1 2 2 2 2 2 2 2 2 -1 2 29 29 29 29 29 29 29 29 29 29 29 2 2 2 29 29 2 2 2 2 2 -1 2 2 -1
-1 1 1 1 1 32 29 29 29 29 31 1 1 -1 2 2 2 2 2 2 2 -1 2 29 29 29 29 29 29 29 2 29 29 2 2 29 29 29 2 2 2 2 2 2 -1 2 2 -1
-1 1 1 1 1 33 28 28 28 28 34 1 1 -1 2 2 2 2 2 2 2 -1 -1 -1 -1 -1 29 29 29 29 29 29 29 29 29 29 29 29 29 -1 2 2 2 2 -1 2 2 -1
-1 -1 -1 -1 -1 -1 -1 -1 -1 -1 -1 -1 -1 -1 2 2 -1 2 13 2 2 2 2 29 29 29 29 29 29 29 29 29 29 29 29 29 29 29 29 -1 2 2 2 2 -1 2 2 -1
-1 -1 -1 -1 -1 -1 -1 -1 -1 -1 -1 -1 -1 -1 2 2 -1 2 2 2 2 2 29 29 29 29 2 29 29 29 29 29 29 29 2 29 29 29 2 -1 2 2 2 2 -1 2 2 -1
-1 -1 -1 -1 -1 -1 -1 -1 -1 -1 -1 -1 -1 -1 2 2 -1 2 2 2 2 2 2 2 2 29 29 29 29 2 13 29 29 29 29 29 -1 -1 -1 -1 2 2 2 2 -1 2 2 -1
-1 -1 -1 -1 -1 -1 -1 -1 -1 -1 -1 -1 -1 -1 2 2 -1 2 2 2 2 2 2 2 2 2 29 29 29 2 2 29 29 29 2 2 2 2 2 2 2 2 2 2 -1 2 2 -1
-1 -1 -1 -1 -1 -1 -1 -1 -1 -1 -1 -1 -1 -1 2 2 -1 2 2 2 2 2 2 2 2 2 -1 29 29 29 29 29 29 -1 2 2 2 2 2 2 2 2 2 2 -1 2 2 -1
-1 -1 -1 -1 -1 -1 -1 -1 -1 -1 -1 -1 -1 -1 2 2 -1 2 2 2 2 2 2 2 2 2 -1 -1 -1 -1 -1 -1 -1 2 2 2 2 2 2 2 2 2 2 2 -1 2 2 -1
-1 -1 -1 -1 -1 -1 -1 -1 -1 -1 -1 -1 -1 -1 2 2 -1 -1 -1 -1 -1 -1 -1 2 2 2 2 2 2 2 2 2 2 2 2 2 2 2 -1 -1 -1 -1 -1 -1 -1 2 2 -1
-1 -1 -1 -1 -1 -1 -1 -1 -1 -1 -1 -1 -1 -1 2 2 2 2 2 2 2 2 2 2 2 2 2 2 2 2 2 2 2 2 2 2 2 2 2 2 2 2 2 2 2 2 2 -1
-1 -1 -1 -1 -1 -1 -1 -1 -1 -1 -1 -1 -1 -1 2 2 2 2 2 2 2 2 2 2 2 2 2 2 2 2 2 2 2 2 2 2 2 2 2 2 2 2 2 2 2 2 2 -1
-1 -1 -1 -1 -1 -1 -1 -1 -1 -1 -1 -1 -1 -1 -1 -1 -1 -1 -1 -1 -1 -1 -1 -1 -1 -1 -1 -1 -1 -1 -1 -1 -1 -1 -1 -1 -1 -1 -1 -1 -1 -1 -1 -1 -1 -1 -1 -1