15 15 15 15 15 15 15 15 15 15 15 15 15 15 15 15 15 15 15 15 15 15 15 15 15 15 15 15 15 15 15 15 15 15 15 15 15 15 15 15 15 15 15 15 15 15 15 15 15 15 15 15 15 15 15 15 15 15 15 15 15 15 15 15 15 15 15 15 15 15 15 15 15 15 15 15 15 15 15 15 15 15 15 15 15 15 15 15 15 15 15 15 15 15 15 15 15 15 15 15 15 15 15 15 15 15 15 15 15 15 15 15 15 15 15 15 15 15 15 15 15 15 15 15 15 15 15 15 15 15 15 15 15 15 15 15 15 15 15 15 15 15 15 15 15 15 15 15 15 15 15 15 15 15 15 15 15 15 15 15 15 15 15 15 15 15 15 15 15 15 15 15 15 15 15 15 15 15 15 15 15 15 15 15 15 15 15 15 15 15 15 15 15 15 15 15 15 15 15 15 15 15 15 15 15 15 15 15 15 15 15 15 15 15 15 15 15 15 15 15 15 15 15 15 15 15 15 15 15 15 15 15 15 15 15 15 15 15 15 15 15 15 15 15 15 15 15 15 15 15 15 15 15 15 15 15
15 13 12 12 14 13 12 13 13 15 1 1 1 1 -1 -1 -1 16 1 -1 -1 1 1 12 -1 -1 15 12 12 12 12 12 12 12 1 12 12 1 12 12 12 12 12 1 12 12 10 10 10 10 10 10 10 10 10 10 10 10 10 10 10 17 17 1 17 -1 1 17 -1 17 17 1 17 -1 17 -1 17 -1 1 1 -1 10 10 10 10 10 10 10 10 1 16 16 16 16 -1 16 16 16 1 16 16 1 1 -1 16 15 3 -1 3 1 -1 -1 1 1 -1 2 -1 -1 -1 -1 3 1 -1 1 -1 1 -1 1 -1 1 -1 -1 1 -1 15 12 14 13 13 12 12 13 14 12 12 12 12 13 12 -1 14 16 12 14 13 14 13 13 12 14 14 12 13 14 13 13 12 14 12 13 13 16 15 1 1 1 -1 1 1 1 -1 -1 -1 10 10 10 10 10 10 10 10 10 10 10 1 -1 -1 -1 -1 16 16 -1 -1 1 -1 -1 1 -1 1 -1 1 1 -1 16 -1 1 -1 1 -1 -1 1 1 15 12 12 12 12 12 12 12 12 12 12 12 12 12 12 12 12 12 12 12 15 1 1 17 1 -1 1 8 3 9 -1 16 1 15
15 13 14 13 13 14 13 12 14 15 1 1 1 -1 1 1 1 -1 1 12 -1 12 -1 1 1 1 15 -1 12 12 1 12 12 12 12 -1 12 1 -1 12 12 12 10 10 10 2 2 2 2 2 2 2 3 2 2 3 3 2 3 3 3 3 10 10 17 17 10 10 10 10 10 10 10 10 10 10 10 10 10 10 2 2 3 3 3 3 3 2 2 10 10 10 10 16 -1 1 16 -1 1 16 1 -1 1 -1 16 15 -1 -1 1 1 1 2 -1 -1 1 1 1 -1 -1 1 1 3 -1 -1 1 1 -1 2 -1 -1 2 1 1 -1 15 13 14 14 13 13 16 14 14 12 10 10 10 10 10 10 10 10 10 10 10 10 10 10 10 10 10 10 14 12 13 13 13 14 13 13 12 13 15 1 1 -1 12 16 -1 -1 10 10 10 2 2 2 3 3 2 2 2 2 2 2 10 10 -1 -1 1 -1 1 -1 1 12 -1 1 1 1 16 1 1 1 -1 1 -1 1 1 1 -1 1 1 -1 15 12 12 12 12 12 12 12 12 12 12 12 12 12 12 12 1 -1 12 12 15 1 17 -1 -1 1 1 8 3 9 16 -1 16 15
15 14 12 14 14 13 12 14 13 15 1 -1 1 -1 -1 16 1 16 -1 -1 -1 1 1 -1 12 1 15 12 12 12 12 12 12 12 12 12 12 12 12 12 10 10 3 2 2 2 11 11 11 11 11 11 11 11 11 11 11 11 11 11 11 3 3 3 2 3 3 2 3 3 3 3 3 3 2 2 3 3 3 3 3 11 11 11 11 11 11 11 11 3 3 3 3 -1 -1 -1 16 -1 16 16 -1 1 -1 16 -1 15 -1 2 3 -1 1 1 1 -1 3 1 2 -1 1 -1 -1 1 -1 1 1 -1 -1 1 -1 -1 3 1 3 1 15 14 13 12 16 14 13 13 12 17 2 3 3 2 3 3 3 2 3 3 2 3 2 2 3 3 3 2 2 10 10 14 14 17 13 12 12 12 15 1 1 -1 -1 16 10 10 3 2 3 11 11 11 11 11 11 11 11 11 11 11 3 3 10 10 10 10 1 1 -1 1 1 1 16 1 -1 12 -1 1 1 -1 -1 -1 1 -1 -1 1 1 1 15 12 12 12 12 12 12 12 12 12 -1 12 12 12 12 12 12 12 12 12 15 -1 17 17 -1 -1 1 8 2 9 16 16 -1 15
15 8 3 9 17 14 12 13 13 15 -1 -1 -1 1 16 -1 1 -1 1 12 1 1 -1 16 -1 1 15 12 12 12 12 12 -1 12 12 12 -1 12 12 3 3 3 11 11 11 12 3 -1 2 -1 1 2 -1 1 3 1 -1 2 -1 2 1 3 11 11 3 2 11 11 11 11 11 11 11 11 11 11 11 11 11 11 14 13 -1 14 13 13 13 14 13 11 11 11 8 2 9 -1 -1 -1 16 16 1 16 1 1 16 15 3 -1 3 1 1 -1 -1 3 3 1 -1 2 1 1 1 -1 1 2 1 1 1 -1 2 2 1 3 2 -1 15 14 12 14 13 13 12 16 16 4 11 11 11 11 11 11 11 11 11 11 11 11 11 11 11 11 11 11 2 2 2 3 14 12 12 14 -1 12 15 1 1 1 1 2 2 3 11 11 11 -1 -1 -1 12 1 -1 -1 1 1 1 1 11 11 2 2 2 2 2 10 10 -1 1 -1 1 1 16 16 -1 1 -1 -1 1 -1 -1 -1 -1 -1 -1 -1 15 12 12 -1 12 12 12 12 12 12 12 12 12 12 12 12 12 1 12 12 15 1 17 -1 17 17 -1 8 3 9 16 16 1 15
15 8 2 9 14 13 14 14 14 15 1 -1 1 -1 -1 1 1 -1 1 1 1 -1 16 -1 1 1 15 12 12 12 1 12 1 -1 12 12 12 12 2 2 11 11 12 12 12 15 15 15 15 15 15 15 15 15 15 15 15 15 15 15 15 15 1 1 8 2 9 15 15 15 15 15 15 15 15 15 15 15 15 15 15 15 15 15 15 15 15 15 15 -1 1 1 17 3 2 16 -1 16 16 -1 -1 -1 16 16 1 15 1 2 3 3 -1 -1 -1 3 -1 1 2 -1 2 2 1 -1 2 2 -1 3 1 1 -1 1 1 -1 -1 -1 15 14 13 14 14 14 12 8 3 9 16 16 16 16 16 16 16 16 16 1 -1 1 1 16 16 1 -1 -1 1 11 11 3 3 14 13 12 12 12 15 1 -1 1 3 2 11 11 -1 -1 -1 12 -1 1 -1 -1 12 -1 -1 16 1 -1 12 -1 11 11 11 11 2 3 2 2 1 10 10 10 10 1 1 1 1 -1 1 -1 -1 1 1 -1 -1 1 15 12 12 12 12 12 12 12 12 -1 12 12 12 12 12 12 12 12 12 12 15 -1 17 17 1 17 17 8 3 9 1 1 -1 15
15 12 8 3 9 14 12 -1 14 15 -1 1 -1 1 16 1 -1 -1 -1 1 1 -1 -1 -1 -1 16 15 12 12 12 12 12 12 12 12 12 12 8 3 9 12 1 12 12 12 15 -1 3 -1 2 -1 1 2 1 1 -1 -1 1 1 1 1 1 2 3 8 3 9 13 14 13 14 14 12 12 13 12 -1 13 12 14 13 12 13 12 12 12 12 14 15 17 1 -1 1 17 3 3 16 -1 16 -1 1 16 -1 -1 16 15 1 1 3 1 2 -1 -1 1 2 1 3 1 3 2 1 1 1 1 3 1 1 -1 1 2 2 1 -1 2 15 14 12 13 17 12 13 8 2 9 1 15 15 15 15 15 15 15 15 15 15 15 15 15 15 15 15 15 15 -1 16 -1 3 2 14 14 14 13 15 12 1 8 2 9 1 -1 -1 12 16 16 -1 12 1 16 -1 -1 -1 -1 1 1 -1 -1 1 -1 -1 1 1 11 11 3 2 3 3 2 3 10 10 10 10 10 1 1 -1 1 -1 -1 1 -1 15 12 12 12 12 12 12 12 12 12 1 12 12 12 12 12 12 12 12 12 15 17 -1 1 -1 -1 -1 8 2 9 16 16 1 15
15 13 8 2 9 13 14 12 14 15 16 1 12 16 -1 1 1 1 -1 1 -1 1 1 -1 -1 1 15 12 12 12 12 12 12 12 12 12 8 3 9 12 12 -1 12 12 12 15 1 1 -1 -1 2 -1 1 3 1 3 1 3 -1 1 1 1 -1 -1 8 3 9 12 -1 12 14 12 12 12 13 14 14 12 14 17 12 12 12 12 13 14 13 14 15 17 -1 17 17 1 8 2 9 -1 16 1 -1 16 16 16 16 15 1 3 1 1 -1 3 -1 3 -1 2 1 3 1 1 2 1 -1 1 1 1 -1 3 -1 -1 2 -1 1 1 15 12 12 14 12 14 8 3 9 -1 1 15 -1 -1 1 -1 16 -1 1 1 12 -1 12 1 -1 12 -1 1 15 -1 -1 16 8 3 9 14 14 13 15 12 12 2 2 17 17 17 15 15 15 15 15 15 15 15 15 15 15 15 15 15 15 15 15 15 15 15 15 -1 1 8 3 9 11 11 11 3 2 3 2 2 3 -1 16 -1 1 1 1 -1 15 12 12 12 12 12 12 12 12 12 12 12 -1 12 12 12 12 12 12 12 15 -1 -1 17 1 1 17 8 2 9 16 16 16 15
15 14 8 3 9 13 12 12 14 15 -1 1 1 1 1 -1 -1 1 1 1 1 12 1 -1 -1 -1 15 12 12 12 12 12 12 12 12 12 3 3 12 12 12 12 12 12 12 15 2 3 1 2 1 -1 3 1 -1 1 -1 3 -1 3 3 1 3 3 8 3 9 14 12 -1 12 14 14 14 14 12 13 13 14 12 13 12 14 12 13 13 14 14 15 17 1 -1 1 17 1 8 3 9 16 1 1 16 -1 16 16 15 1 1 2 1 3 1 -1 3 1 2 1 3 1 1 -1 -1 1 1 -1 -1 1 1 -1 1 3 1 -1 -1 15 13 14 12 12 14 8 3 9 1 16 15 -1 15 15 15 15 1 1 1 1 -1 -1 15 15 15 15 -1 15 1 16 -1 8 2 9 14 13 14 15 12 8 3 9 1 -1 -1 17 17 17 17 1 -1 1 1 17 1 17 1 17 17 17 17 17 1 -1 17 15 -1 -1 -1 3 2 1 1 -1 11 11 11 11 11 2 3 -1 12 1 -1 1 -1 15 12 12 12 12 12 12 12 12 12 10 10 12 12 12 12 1 12 12 12 15 17 17 -1 17 -1 8 3 9 16 16 16 16 15
15 17 8 3 9 12 14 13 13 15 -1 -1 -1 -1 16 12 1 1 -1 -1 1 -1 1 1 1 -1 15 -1 12 1 12 12 12 1 12 8 3 9 12 12 12 12 12 12 12 15 -1 -1 -1 2 -1 2 -1 -1 1 2 1 3 3 2 1 1 2 1 2 2 10 10 10 10 10 10 10 10 10 10 10 10 10 14 13 17 13 12 16 14 14 13 15 17 17 -1 -1 1 -1 8 2 9 -1 1 1 -1 16 16 1 15 3 2 3 3 -1 3 -1 -1 1 1 -1 -1 -1 -1 -1 -1 -1 1 1 1 1 1 2 -1 1 -1 1 -1 15 13 12 12 13 8 3 9 -1 1 -1 15 -1 15 -1 -1 15 -1 -1 1 -1 16 1 15 14 17 15 1 15 -1 16 16 16 3 2 16 14 14 15 12 12 2 2 17 17 -1 1 17 17 -1 17 1 -1 17 17 -1 -1 17 17 17 17 1 -1 -1 1 17 15 1 -1 -1 8 3 9 -1 16 -1 -1 1 1 -1 1 3 2 -1 1 1 -1 -1 15 12 12 12 12 12 12 12 1 3 2 3 12 12 12 12 12 1 12 12 15 17 1 17 1 1 8 3 10 16 16 -1 16 15
15 12 8 3 9 13 12 14 12 15 -1 -1 12 -1 16 1 1 1 1 -1 -1 -1 1 1 12 -1 15 12 12 12 12 12 12 12 12 3 2 12 12 12 1 12 12 -1 12 15 -1 1 1 -1 1 3 1 -1 1 3 -1 -1 -1 -1 -1 1 -1 10 3 2 3 2 2 2 2 3 3 2 2 3 2 3 3 2 10 12 12 13 14 13 14 14 15 17 17 1 1 17 17 17 8 2 9 16 1 -1 1 -1 16 15 -1 -1 -1 1 1 2 1 1 2 -1 1 -1 8 3 9 1 1 1 2 1 3 -1 1 -1 1 -1 1 1 15 14 -1 -1 14 8 3 9 1 16 16 15 -1 15 -1 1 15 1 16 -1 15 15 -1 15 12 14 15 -1 15 1 16 16 16 8 3 9 13 12 15 12 12 8 3 9 17 -1 17 17 1 1 17 -1 1 17 17 -1 17 17 -1 1 17 17 17 -1 17 17 15 1 1 -1 8 3 9 16 -1 1 1 16 16 -1 16 8 2 9 1 -1 1 1 15 12 12 12 12 12 12 12 2 3 11 11 12 12 12 12 12 12 12 12 15 1 17 1 -1 17 17 2 3 1 -1 16 16 15
15 -1 8 3 9 13 14 13 14 15 -1 1 -1 -1 1 -1 1 -1 1 1 1 -1 1 -1 1 -1 15 12 12 12 12 12 12 12 8 2 9 -1 12 12 12 12 12 12 12 15 1 1 2 1 -1 1 1 -1 1 -1 1 1 2 10 10 10 3 3 3 -1 11 11 11 11 11 11 11 11 11 11 11 11 11 2 3 2 14 12 13 12 12 13 15 1 1 17 1 1 17 1 8 3 9 -1 16 1 1 1 1 15 -1 3 -1 1 -1 2 2 -1 3 -1 1 3 -1 3 3 1 -1 1 -1 2 1 3 1 2 -1 1 1 2 15 14 13 12 12 8 3 9 16 -1 16 15 -1 15 -1 1 15 -1 -1 -1 15 15 -1 15 14 14 15 -1 15 1 16 16 -1 8 3 9 14 14 15 12 12 12 12 6 10 1 17 -1 17 17 -1 17 1 1 17 -1 17 -1 1 -1 17 17 -1 1 1 17 15 -1 16 12 8 2 9 -1 16 -1 15 16 16 -1 1 -1 8 2 9 1 1 -1 15 12 12 12 12 12 1 8 2 9 12 12 12 12 12 12 12 12 12 12 15 17 17 17 -1 17 8 3 9 -1 16 -1 1 15
15 14 8 3 9 12 -1 14 13 15 -1 1 1 16 -1 1 12 -1 -1 -1 -1 -1 -1 1 1 -1 15 12 12 12 12 12 12 12 8 3 9 12 12 12 1 12 12 12 12 15 -1 3 -1 -1 2 -1 -1 3 -1 1 10 10 10 2 3 3 3 11 1 -1 -1 -1 1 -1 1 1 3 1 -1 3 1 -1 1 -1 8 3 9 13 14 13 -1 13 15 -1 1 17 17 -1 17 17 8 2 9 16 16 -1 16 -1 -1 15 2 -1 1 3 2 -1 -1 1 -1 2 -1 -1 1 8 3 9 3 -1 -1 -1 1 1 -1 1 -1 1 1 -1 15 17 14 14 12 8 3 9 16 -1 16 15 12 15 15 15 15 1 -1 15 15 15 1 15 15 15 15 1 15 16 -1 16 16 8 3 9 14 17 15 12 12 12 12 5 2 2 10 10 10 10 10 10 10 10 10 10 10 10 10 10 17 1 17 17 17 -1 15 1 -1 -1 8 2 9 -1 1 1 15 16 16 16 16 -1 8 3 9 -1 -1 1 15 12 12 12 12 12 12 8 3 9 12 12 12 12 12 12 12 12 1 12 15 -1 1 17 1 8 2 9 16 1 16 -1 1 15
15 13 8 3 9 12 13 13 17 15 1 -1 -1 -1 -1 12 1 1 1 -1 -1 -1 -1 1 12 -1 15 12 12 12 12 12 12 12 8 2 9 12 12 12 -1 12 12 12 12 15 2 -1 2 1 2 3 1 2 1 10 2 3 2 11 11 11 3 1 3 -1 -1 1 3 3 1 -1 -1 -1 3 -1 -1 -1 2 -1 -1 8 3 9 16 14 14 13 15 17 17 17 1 1 1 1 8 2 9 16 1 16 -1 1 1 15 3 1 1 1 1 -1 1 1 -1 -1 1 -1 -1 8 3 9 -1 -1 1 1 3 1 -1 -1 -1 1 -1 1 15 13 13 14 13 8 3 9 -1 16 -1 15 -1 -1 1 1 -1 -1 16 15 15 15 1 1 -1 1 -1 1 15 -1 16 -1 16 8 2 9 14 14 15 12 12 12 1 12 11 2 2 2 2 3 2 3 2 2 3 3 2 2 2 3 10 1 -1 1 17 17 15 1 1 1 8 3 9 -1 -1 -1 15 1 16 1 -1 16 16 3 3 1 -1 -1 15 12 12 1 1 12 12 8 2 9 12 12 12 12 1 12 12 12 12 1 15 -1 17 -1 -1 8 3 9 1 16 -1 -1 16 15
15 14 13 8 2 9 12 17 12 15 1 1 1 1 1 1 1 1 -1 -1 1 1 1 12 -1 -1 15 12 12 12 12 12 -1 12 8 2 9 12 12 -1 12 12 12 12 12 15 -1 -1 2 -1 1 2 -1 2 2 3 11 11 11 -1 -1 -1 1 -1 -1 -1 2 -1 3 -1 3 2 1 1 1 1 -1 2 1 -1 -1 8 2 9 14 12 12 17 15 17 17 1 17 -1 17 17 17 8 2 9 -1 1 1 16 16 15 2 -1 1 -1 -1 1 -1 1 3 -1 1 1 1 8 3 9 2 1 2 1 2 -1 -1 -1 -1 -1 -1 -1 15 13 14 17 12 8 2 9 -1 16 1 15 15 15 15 15 15 15 15 15 15 15 15 15 15 15 15 15 15 1 1 -1 16 8 2 9 14 13 15 12 12 12 12 12 12 12 11 11 11 11 11 11 11 11 11 11 11 11 11 11 3 2 -1 17 1 17 15 -1 -1 1 -1 2 3 -1 1 16 15 16 -1 16 16 -1 16 8 3 9 -1 16 15 12 12 -1 -1 12 12 8 2 9 12 12 12 12 12 12 12 12 12 12 15 -1 17 -1 17 8 3 9 1 16 -1 -1 -1 15
15 14 12 8 2 9 12 14 12 15 -1 1 12 -1 1 1 -1 1 1 1 1 1 12 -1 1 -1 15 1 -1 12 12 12 12 12 8 2 9 1 12 12 12 12 12 12 12 15 1 -1 1 1 -1 1 1 3 3 11 1 -1 -1 -1 -1 2 3 -1 -1 -1 -1 2 1 -1 -1 -1 2 -1 1 -1 -1 2 2 3 -1 -1 8 3 9 12 12 17 15 17 17 -1 17 1 17 -1 17 8 3 9 16 16 1 1 16 15 -1 -1 1 1 2 2 3 -1 1 2 1 2 3 8 2 9 2 1 1 -1 1 -1 -1 3 -1 -1 2 1 15 -1 14 13 13 8 3 9 -1 16 -1 16 16 16 -1 15 -1 1 1 1 16 1 -1 1 15 16 1 -1 16 16 1 16 16 8 3 9 13 13 15 12 12 12 12 12 12 12 12 12 -1 12 12 12 12 12 12 12 12 12 12 12 11 2 3 17 -1 -1 15 1 1 1 1 8 2 9 1 16 15 1 -1 16 16 1 16 8 2 9 1 1 15 12 12 12 12 12 12 8 3 9 12 12 12 12 -1 12 12 12 12 12 15 1 17 1 1 8 3 9 -1 16 16 -1 1 15
15 14 13 12 2 2 14 14 17 15 1 1 1 12 1 1 1 1 -1 12 -1 -1 1 1 -1 12 15 12 1 12 12 12 -1 12 8 2 9 12 12 12 12 12 12 12 -1 15 3 -1 1 1 1 2 3 2 3 1 2 1 1 -1 -1 -1 2 2 -1 1 3 3 3 3 3 1 2 2 -1 -1 3 -1 1 -1 -1 2 8 2 9 17 -1 17 15 17 1 17 -1 -1 17 17 -1 8 3 9 -1 1 16 -1 -1 15 15 15 15 15 15 15 15 15 15 15 15 15 12 8 3 9 -1 17 15 15 15 15 15 15 15 15 15 15 15 13 12 14 17 8 2 9 16 1 1 1 16 16 1 15 -1 -1 -1 -1 -1 1 16 1 15 1 16 16 1 -1 16 16 1 8 2 9 -1 14 15 -1 12 12 12 12 1 12 12 12 12 12 1 12 12 12 -1 12 -1 12 12 12 12 8 3 9 1 17 15 -1 -1 1 -1 8 2 9 16 1 15 -1 1 16 16 -1 16 8 2 9 12 -1 15 12 12 1 12 1 12 3 3 12 12 12 12 12 12 12 12 12 12 12 15 1 17 1 -1 8 2 9 1 1 16 1 16 15
15 16 14 14 8 2 9 13 12 15 1 1 -1 -1 -1 1 1 12 12 1 1 -1 1 1 -1 1 15 12 12 12 12 12 12 8 2 9 12 12 12 12 12 12 12 -1 12 15 -1 -1 1 -1 1 8 3 9 2 2 3 1 2 -1 -1 -1 1 -1 3 -1 1 1 3 2 -1 2 3 -1 3 -1 -1 -1 3 1 -1 2 8 2 9 13 14 14 15 1 17 -1 17 17 -1 1 17 8 2 10 10 10 10 10 10 10 10 10 10 10 10 10 10 10 10 10 10 10 8 2 10 10 10 10 10 10 10 10 10 10 10 10 10 10 10 10 10 10 14 8 2 9 16 1 1 16 -1 -1 -1 15 1 1 -1 -1 -1 -1 16 12 15 1 16 16 16 1 16 1 -1 3 3 12 14 13 15 12 12 12 12 12 12 12 12 12 12 12 12 12 12 12 1 1 12 12 12 12 12 12 8 3 9 -1 15 1 -1 16 -1 8 2 9 -1 1 15 16 16 16 16 -1 -1 8 3 9 1 1 15 12 12 12 12 12 8 2 9 12 12 12 12 12 12 12 12 12 12 12 15 17 17 1 -1 8 2 9 16 1 1 16 16 15
15 13 14 13 8 2 9 14 12 15 -1 1 -1 1 -1 -1 1 12 12 -1 1 -1 1 1 1 1 15 12 12 12 -1 12 1 8 3 9 12 12 -1 12 12 12 12 12 12 15 1 -1 2 1 8 3 9 1 3 1 -1 15 15 15 15 15 15 15 15 15 15 15 15 15 15 15 15 15 15 15 15 15 15 15 1 -1 8 3 9 12 14 17 15 17 -1 17 17 1 17 17 -1 1 2 2 2 3 3 2 3 2 3 3 2 3 3 2 3 2 3 2 3 2 2 2 2 3 2 2 2 2 2 2 3 3 2 2 3 2 3 2 2 3 10 10 2 9 -1 -1 16 16 1 -1 1 15 -1 -1 -1 1 1 -1 -1 1 15 16 16 16 -1 -1 1 -1 8 2 9 14 13 12 15 15 15 15 15 15 15 15 15 15 15 15 15 15 15 15 15 15 15 15 15 15 15 16 8 3 9 -1 15 -1 1 1 -1 8 3 9 1 16 15 16 1 1 16 1 1 16 8 3 9 1 15 12 12 12 12 12 3 3 12 12 12 12 12 12 12 12 12 12 12 12 15 1 1 -1 -1 8 3 9 16 -1 1 1 16 15
15 13 -1 12 12 3 2 13 13 15 -1 1 16 -1 1 -1 -1 -1 -1 -1 1 -1 1 -1 -1 -1 15 12 12 -1 12 12 12 8 3 9 12 -1 12 12 1 12 12 12 12 15 -1 1 3 2 8 2 9 -1 2 -1 -1 15 13 13 13 14 -1 12 14 13 13 14 12 12 16 14 14 16 14 13 12 13 -1 15 3 -1 8 3 9 12 13 16 15 1 17 1 17 1 17 -1 1 8 2 9 11 11 11 11 11 11 11 11 11 11 11 11 11 11 11 11 11 8 3 9 11 11 11 11 11 11 11 11 11 11 11 11 11 11 11 11 11 11 3 3 2 10 16 16 -1 16 -1 16 16 15 15 15 15 15 15 15 15 15 15 1 -1 1 -1 16 1 16 8 2 9 12 14 -1 15 -1 16 -1 16 16 16 16 16 16 -1 16 -1 16 16 16 16 16 1 16 -1 16 16 -1 8 2 9 2 15 1 12 1 -1 8 3 9 16 -1 15 16 16 16 -1 16 16 1 16 3 2 10 1 12 -1 1 12 2 2 12 12 12 12 12 12 12 12 12 12 12 1 12 15 17 17 -1 -1 17 8 3 9 -1 16 16 -1 15
15 14 14 13 12 8 3 10 14 14 1 -1 -1 10 10 10 10 10 10 10 10 10 10 -1 1 -1 1 12 12 10 10 10 10 3 2 12 12 12 12 12 12 12 12 12 12 15 3 1 3 2 8 3 9 1 2 1 -1 15 12 12 12 13 14 14 12 13 14 13 16 12 12 12 12 13 13 12 12 12 12 15 1 3 8 2 9 14 12 -1 15 -1 17 -1 1 -1 17 17 -1 8 3 9 1 17 17 17 -1 -1 -1 1 16 1 1 1 1 12 -1 -1 1 8 3 9 12 12 12 1 12 1 12 12 12 12 12 12 12 12 17 17 1 -1 11 11 17 3 3 -1 16 16 16 16 16 16 -1 -1 -1 -1 16 -1 16 16 16 1 16 -1 -1 -1 1 1 8 3 9 13 12 13 15 16 1 1 16 16 16 16 16 1 -1 -1 1 16 16 16 16 1 -1 -1 16 16 16 16 8 3 9 3 15 -1 16 1 -1 8 2 9 -1 16 15 16 1 16 16 1 16 16 1 16 2 2 10 10 10 10 2 2 12 12 12 12 12 12 12 12 12 12 12 12 12 12 15 -1 17 -1 17 17 8 3 9 16 16 1 16 15
15 16 13 13 17 14 2 3 2 10 -1 10 10 2 3 2 3 3 2 3 2 3 3 10 10 10 10 10 10 2 2 2 3 3 2 12 12 12 -1 12 12 12 12 12 12 15 2 3 3 -1 8 3 9 1 2 -1 -1 15 14 12 -1 14 14 13 14 16 17 14 12 13 -1 13 14 12 16 12 13 12 17 15 -1 3 8 2 9 14 14 13 15 1 -1 1 -1 17 17 -1 -1 8 2 9 -1 17 17 1 1 15 15 15 15 15 15 15 15 15 15 15 16 8 3 9 1 15 15 15 15 15 15 15 15 15 15 15 15 15 15 17 17 -1 17 17 17 8 3 9 1 -1 16 -1 -1 16 -1 -1 -1 -1 16 16 1 16 -1 1 1 1 -1 16 -1 -1 8 2 9 -1 12 12 15 16 -1 16 1 -1 16 16 1 1 16 -1 16 16 1 16 16 1 1 -1 16 -1 -1 8 3 9 2 1 15 1 -1 1 -1 8 2 9 -1 1 15 1 16 16 16 16 16 16 16 1 16 11 3 3 2 2 2 12 12 12 12 12 1 12 12 12 12 12 12 12 12 12 15 -1 1 1 17 1 8 3 9 16 1 1 -1 15
15 14 13 13 13 13 -1 11 3 3 2 3 3 11 11 11 11 11 11 11 11 11 11 3 3 3 3 2 3 11 11 11 11 8 3 9 12 12 12 -1 12 12 12 12 12 15 2 1 3 2 4 -1 -1 -1 1 -1 -1 15 14 13 13 12 12 14 13 13 14 13 13 16 13 17 12 12 12 12 16 12 13 15 1 -1 8 3 9 13 13 12 15 1 17 17 -1 17 17 1 17 1 -1 17 1 1 1 17 -1 15 1 1 1 16 16 1 16 16 16 16 1 8 3 9 16 -1 16 1 16 16 -1 16 16 1 16 16 -1 -1 15 1 17 17 1 1 17 -1 17 6 10 16 16 16 1 -1 16 -1 1 16 16 1 1 16 16 16 16 16 16 16 16 1 8 3 9 13 14 14 15 16 16 -1 16 16 16 -1 -1 16 -1 16 16 -1 -1 1 -1 -1 16 1 -1 -1 10 2 3 3 2 -1 15 -1 -1 1 -1 8 3 9 -1 -1 15 16 -1 16 16 1 16 1 -1 16 1 16 11 11 11 11 12 12 12 1 12 12 12 12 12 12 12 12 12 12 12 12 15 17 17 -1 -1 17 2 3 -1 16 16 -1 -1 15
15 14 12 17 14 12 14 12 14 8 2 9 11 -1 -1 -1 1 1 -1 2 -1 -1 2 11 11 11 11 11 11 13 12 12 14 8 3 9 12 12 12 12 12 12 12 12 12 15 3 3 -1 -1 7 -1 1 1 -1 2 -1 15 13 12 17 13 13 14 13 13 12 12 13 12 12 17 14 14 12 12 12 12 14 15 1 1 8 3 9 13 17 12 15 17 1 17 1 1 17 17 17 1 1 17 1 1 17 -1 -1 15 1 1 1 16 1 -1 -1 -1 16 1 -1 8 3 9 1 16 16 16 16 1 -1 -1 -1 -1 -1 16 -1 -1 15 17 1 -1 1 17 17 17 17 5 3 2 1 -1 16 16 1 16 16 16 -1 1 1 1 16 -1 1 16 1 16 -1 8 3 9 14 14 14 12 15 1 1 16 16 -1 16 16 1 16 16 1 -1 1 16 -1 16 16 1 -1 16 3 3 3 -1 -1 1 2 15 1 -1 1 -1 8 3 9 1 -1 15 16 -1 -1 -1 16 16 16 1 1 16 16 16 -1 12 12 12 12 1 12 12 12 12 12 12 12 12 12 12 12 12 12 15 17 -1 -1 -1 8 2 9 -1 -1 16 16 16 15
15 12 13 12 12 13 12 -1 13 12 -1 2 -1 -1 -1 2 2 -1 -1 2 2 3 -1 2 3 1 1 12 12 13 12 14 12 12 8 2 9 1 12 1 -1 12 12 12 12 15 2 3 -1 2 -1 -1 1 -1 -1 2 1 15 12 12 13 12 13 14 -1 14 12 14 14 13 12 14 12 12 14 12 13 14 -1 15 1 3 8 3 9 13 12 13 15 17 17 -1 -1 1 1 -1 17 1 17 -1 17 17 -1 1 1 15 1 1 1 16 16 16 16 1 1 16 16 8 2 9 16 16 -1 16 16 -1 -1 1 -1 16 1 1 16 1 15 -1 17 17 -1 17 -1 17 17 1 11 3 3 10 10 10 16 16 1 16 16 16 16 1 16 16 1 1 -1 16 1 8 3 9 17 17 17 14 15 16 16 16 16 16 -1 -1 -1 1 1 16 16 16 1 1 1 16 16 10 2 3 11 -1 1 1 1 2 15 -1 1 1 1 8 3 9 -1 16 15 15 15 15 15 15 15 15 15 15 15 15 15 15 15 15 15 15 15 15 15 15 15 15 15 15 15 15 15 15 15 15 15 17 1 1 10 10 2 9 16 1 16 -1 1 15
15 15 15 15 15 15 15 15 15 15 15 15 15 15 15 15 15 15 15 15 15 15 15 15 15 15 15 14 13 13 12 14 13 16 8 2 9 12 12 12 12 12 12 12 12 15 3 1 -1 1 2 3 -1 1 3 1 1 15 14 12 12 12 -1 14 14 13 12 13 12 12 14 13 13 12 17 13 13 13 13 15 1 -1 8 2 9 17 13 13 15 17 17 -1 17 1 17 1 17 17 17 17 17 17 1 -1 17 15 16 -1 1 -1 -1 16 16 16 1 -1 16 8 3 9 16 16 16 -1 16 -1 16 16 16 16 16 16 16 16 15 17 -1 1 17 17 17 -1 17 -1 -1 17 2 2 3 3 10 10 10 10 10 10 10 10 10 10 10 10 10 10 10 8 3 9 13 17 12 14 15 16 1 16 -1 16 16 -1 -1 16 16 -1 16 16 -1 16 16 10 10 3 2 -1 2 2 1 2 2 1 15 16 -1 1 16 16 2 2 17 1 17 17 17 17 -1 17 -1 17 17 17 17 1 1 1 1 1 -1 -1 17 1 1 1 17 17 17 1 1 17 1 17 1 17 1 10 10 10 3 2 16 -1 1 16 -1 16 16 15
15 1 -1 -1 -1 1 -1 1 -1 1 1 1 -1 -1 -1 1 -1 1 -1 16 -1 -1 16 -1 -1 -1 -1 13 12 13 12 14 12 12 8 2 9 12 12 12 12 12 -1 12 12 15 1 3 -1 1 -1 -1 2 -1 3 1 -1 15 14 17 13 13 14 14 13 13 13 14 14 8 2 9 14 13 12 14 14 14 14 15 2 2 2 2 14 14 12 14 15 17 -1 -1 -1 1 17 -1 17 17 17 17 17 1 -1 17 -1 15 1 16 1 1 16 16 1 -1 16 16 16 -1 8 2 9 1 -1 16 -1 1 16 16 -1 16 16 -1 16 -1 15 17 -1 -1 -1 1 -1 -1 -1 17 1 -1 17 11 11 11 3 2 2 2 3 3 2 3 2 3 2 3 3 2 3 10 2 9 12 14 12 13 15 1 -1 1 16 -1 -1 16 16 16 16 -1 -1 -1 10 10 2 3 3 11 3 -1 -1 2 -1 -1 -1 3 15 -1 16 16 16 16 8 3 10 -1 1 17 17 1 1 1 1 -1 1 1 17 1 1 17 17 17 17 17 1 17 17 -1 17 17 10 10 10 10 10 10 10 10 3 3 2 2 11 11 16 16 16 16 -1 1 -1 15
15 1 -1 -1 1 1 16 -1 -1 1 -1 1 -1 -1 1 -1 -1 -1 -1 1 -1 1 16 -1 -1 1 -1 12 13 12 14 13 14 10 3 3 12 12 12 12 12 12 12 12 1 15 -1 3 3 3 2 -1 1 1 -1 1 1 15 13 12 14 13 14 12 13 12 14 -1 14 14 2 3 13 12 12 14 14 12 13 12 3 10 2 9 14 13 14 13 15 17 -1 1 -1 -1 -1 17 17 17 -1 1 -1 -1 17 17 17 15 -1 16 -1 16 -1 -1 16 16 16 16 1 16 8 2 9 16 16 1 1 -1 16 -1 -1 1 16 1 -1 1 15 17 17 17 17 17 1 1 17 17 17 17 -1 1 17 1 11 11 11 11 11 11 11 11 11 11 11 11 11 11 11 2 2 3 12 14 14 14 15 1 1 16 -1 1 16 1 1 16 -1 10 10 2 3 3 3 11 11 -1 3 1 2 -1 3 1 -1 -1 15 -1 16 -1 16 1 -1 2 3 10 10 -1 17 1 17 1 1 17 -1 17 10 10 10 10 10 10 10 10 10 10 10 10 10 2 3 3 2 3 2 2 2 3 2 11 11 11 -1 16 16 1 16 1 16 -1 -1 15
15 -1 1 12 1 -1 16 -1 1 -1 10 10 10 10 10 10 10 10 10 10 10 10 10 10 10 10 10 10 10 10 10 10 10 3 3 12 12 12 12 12 12 12 12 12 12 15 -1 1 1 -1 -1 3 3 1 2 -1 -1 15 13 12 13 14 13 16 13 12 14 13 14 14 14 3 2 10 10 10 10 10 10 10 2 2 14 14 14 12 13 -1 15 -1 -1 -1 17 17 17 17 17 -1 17 17 17 1 1 17 17 15 -1 16 16 16 -1 -1 1 16 -1 1 1 1 1 16 6 1 -1 1 -1 16 16 -1 1 16 -1 1 16 1 15 17 17 17 1 -1 1 17 17 -1 17 17 1 17 1 -1 17 17 17 17 -1 17 17 17 1 1 17 17 17 17 1 11 -1 2 2 10 10 10 10 10 10 10 10 10 10 10 10 10 2 3 3 3 11 11 -1 1 1 -1 1 3 3 1 -1 3 -1 -1 15 -1 1 16 16 16 1 16 11 2 2 10 10 10 10 10 10 10 10 10 2 3 3 3 3 3 2 2 2 2 3 3 3 2 11 11 11 11 11 11 11 11 1 16 16 1 16 16 1 1 1 16 1 16 16 15
15 -1 1 -1 1 1 -1 -1 16 -1 3 2 3 2 2 2 3 2 2 2 2 3 2 3 3 2 3 3 2 3 3 3 3 11 12 12 12 12 12 12 12 12 12 12 12 15 1 1 1 -1 -1 1 -1 -1 3 3 1 15 12 14 14 14 13 17 13 14 13 13 12 12 -1 12 3 2 2 3 2 3 3 2 2 11 12 14 13 14 13 12 15 1 17 1 17 17 17 17 17 1 17 17 17 17 17 17 17 15 -1 -1 16 1 -1 -1 16 16 1 16 -1 -1 -1 16 5 16 -1 -1 1 16 16 16 1 16 16 1 16 -1 15 1 -1 1 17 17 -1 -1 17 17 -1 17 -1 -1 17 17 -1 17 -1 17 1 17 1 17 -1 17 17 1 1 1 -1 -1 17 -1 2 2 3 2 3 3 2 2 2 3 2 2 3 2 2 11 11 2 -1 1 1 2 1 2 -1 1 1 1 3 1 -1 1 15 1 -1 16 16 -1 -1 1 16 11 11 2 3 3 3 2 3 2 2 3 11 11 11 11 11 11 11 11 11 11 11 11 11 1 16 16 1 1 16 16 16 16 16 16 -1 16 16 16 1 16 16 1 16 16 16 15
15 1 -1 -1 -1 1 1 1 -1 1 11 11 11 11 11 11 11 11 11 11 11 11 11 11 11 11 11 11 11 11 11 11 11 12 12 12 12 1 -1 12 12 12 12 12 12 15 -1 1 1 1 1 2 2 1 1 -1 2 15 13 13 13 12 13 13 13 13 13 13 14 12 13 14 12 11 11 11 11 11 11 11 13 12 12 13 13 17 14 14 15 1 17 1 17 17 17 17 17 -1 1 17 17 -1 -1 -1 1 15 16 -1 16 -1 1 16 16 1 -1 -1 16 1 16 16 16 -1 -1 16 1 16 -1 1 16 1 1 -1 -1 16 15 17 -1 17 17 -1 -1 -1 -1 17 -1 -1 17 17 17 -1 17 17 1 1 17 17 1 17 17 17 1 17 1 17 17 17 -1 -1 -1 11 11 11 11 11 11 11 11 11 11 11 11 11 2 3 2 -1 -1 3 -1 -1 1 -1 -1 3 -1 2 2 1 -1 2 15 16 16 16 16 1 16 -1 16 -1 16 11 11 11 11 11 11 11 11 11 -1 -1 -1 -1 -1 -1 -1 16 16 -1 16 -1 1 16 1 16 16 16 1 1 -1 1 16 1 16 16 16 -1 16 16 1 16 16 -1 -1 15
15 15 15 15 15 15 15 15 15 15 15 15 15 15 15 15 15 15 15 15 15 15 15 15 15 15 15 15 15 15 15 15 15 15 15 15 15 15 15 15 15 15 15 15 15 15 15 15 15 15 15 15 15 15 15 15 15 15 15 15 15 15 15 15 15 15 15 15 15 15 15 15 15 15 15 15 15 15 15 15 15 15 15 15 15 15 15 15 15 15 15 15 15 15 15 15 15 15 15 15 15 15 15 15 15 15 15 15 15 15 15 15 15 15 15 15 15 15 15 15 15 15 15 15 15 15 15 15 15 15 15 15 15 15 15 15 15 15 15 15 15 15 15 15 15 15 15 15 15 15 15 15 15 15 15 15 15 15 15 15 15 15 15 15 15 15 15 15 15 15 15 15 15 15 15 15 15 15 15 15 15 15 15 15 15 15 15 15 15 15 15 15 15 15 15 15 15 15 15 15 15 15 15 15 15 15 15 15 15 15 15 15 15 15 15 15 15 15 15 15 15 15 15 15 15 15 15 15 15 15 15 15 15 15 15 15 15 15 15 15 15 15 15 15 15 15 15 15 15 15 15 15 15 15 15 15
