15 15 15 15 15 15 15 15 15 15 15 15 15 15 15 15 15 15 15 15 15 15 15 15 15 15 15 15 15 15 15 15 15 15 15 15 15 15 15 15 15 15 15 15 15 15 15 15 15 15 15 15 15 15 15 15 15 15 15 15 15 15 15 15
15 1 -1 1 -1 1 1 -1 1 15 15 15 15 15 15 15 1 1 -1 -1 -1 1 -1 -1 1 1 -1 15 15 15 15 15 -1 1 -1 -1 1 -1 1 1 1 1 1 -1 15 15 15 1 -1 1 -1 -1 1 -1 2 1 1 -1 1 -1 1 -1 1 15
15 1 -1 14 -1 1 -1 1 1 15 15 15 15 15 15 15 1 -1 -1 1 14 1 1 1 -1 1 -1 15 15 15 15 15 -1 1 -1 1 1 1 -1 14 1 -1 -1 -1 15 15 15 -1 1 -1 -1 1 14 -1 -1 -1 -1 -1 1 14 -1 1 -1 15
15 -1 -1 1 -1 1 -1 -1 -1 15 15 15 15 15 15 15 1 1 1 -1 1 -1 -1 -1 2 -1 1 15 15 15 15 15 -1 1 1 3 -1 1 -1 1 1 1 -1 1 15 15 15 -1 -1 -1 2 2 2 1 1 1 1 1 1 1 1 2 1 15
15 -1 -1 3 1 2 1 1 1 -1 -1 1 -100 2 2 3 3 3 3 3 -1 1 -1 2 1 -1 1 -1 -1 -100 1 -1 1 1 -1 1 1 1 -1 1 1 1 1 3 2 -100 3 3 3 2 -1 -1 1 -1 1 1 -1 -1 -1 1 -1 -1 1 15
15 1 1 -1 3 1 3 2 3 3 2 3 -100 1 1 -1 -1 1 -1 -1 -1 -1 1 -1 -1 -1 1 3 3 -100 3 3 2 2 3 1 -1 1 1 2 -1 -1 -1 2 -1 -100 -1 -1 -1 -1 -1 -1 -1 -1 1 1 1 1 1 1 1 -1 -1 15
15 1 1 -1 1 1 -1 -1 -1 15 15 15 15 15 15 15 1 1 1 2 -1 1 -1 -1 1 14 1 15 15 15 15 15 1 1 14 1 -1 1 -1 1 1 1 1 1 15 15 15 1 -1 1 -1 -1 14 1 3 1 1 14 -1 1 -1 1 1 15
15 -1 1 -1 -1 14 -1 -1 1 15 15 15 15 15 15 15 -1 1 -1 1 -1 2 -1 1 -1 1 -1 15 15 15 15 15 1 1 -1 -1 -1 3 -1 1 -1 -1 1 1 15 15 15 -1 -1 1 -1 1 1 1 -1 -1 -1 1 1 -1 1 2 -1 15
15 1 -1 1 -1 -1 -1 -1 -1 15 15 15 15 15 15 15 1 -1 -1 -1 1 1 -1 1 1 1 1 15 15 15 15 15 -1 -1 1 1 1 1 -1 -1 -1 -1 1 1 15 15 15 1 -1 1 -1 1 1 -1 1 -1 -1 -1 1 -1 -1 -1 1 15
15 15 15 15 15 15 15 15 15 15 15 15 15 15 15 15 15 15 15 15 15 15 15 15 15 15 15 15 15 15 15 15 15 15 15 15 15 15 15 15 15 15 15 15 15 15 15 15 15 15 15 15 15 15 15 15 15 15 15 15 15 15 15 15