-24 -22 -22 -23 -23 -22 -21 -21 -21 -21 -21 -21 -21 -42 -42 -42 -25
-24 -41 -41 -43 -19 -18 -18 -28 -45 -28 -18 -18 -18 -20 -20 -20 -25
-24 -41 -44 -44 -43 -19 -18 -35 -27 -33 -18 -20 -20 -20 -20 -20 -25
-24 -41 -43 -44 -44 -18 -19 -18 -18 -18 -18 -20 -20 -20 -20 -20 -25
-24 -41 -43 -44 -43 -19 -18 -18 -18 -18 -20 -18 -20 -20 -20 -20 -25
-24 -22 -23 -22 -18 -43 -18 -18 -18 -18 -18 -18 -18 -42 -42 -42 -25
-24 -18 -18 -20 -20 -20 -18 -18 -18 -18 -20 -18 -18 -18 -20 -18 -25
-24 -18 -20 -20 -20 -20 -20 -36 -27 -34 -20 -20 -18 -20 -20 -18 -25
-24 -18 -20 -20 -18 -20 -20 -28 -45 -28 -20 -20 -20 -20 -20 -18 -25
-24 -21 -21 -21 -21 -21 -21 -21 -21 -21 -21 -21 -21 -21 -21 -21 -25

