24  22  22  22  22  21  22  21  22  42  42  42  42  42  42  42  25
24  41  41  41  43  18  18  18  18  18  18  20  20  20  20  20  25
24  41  41  43  18  18  18  20  20  20  20  20  20  20  20  20  25
24  41  43  43  43  18  20  20  20  20  20  20  20  41  20  20  25
24  41  43  43  19  20  20  19  18  20  20  20  20  20  20  20  25
24  41  41  43  43  19  18  19  18  18  19  20  20  20  20  20  25
24  22  22  23  22  22  18  18  18  18  18  42  42  42  42  42  25
24  18  18  18  18  18  19  18  18  18  18  18  18  18  20  20  25
24  18  18  18  19  18  18  18  18  18  19  18  19  18  18  20  25
24  27  27  34  18  18  18  18  18  18  18  18  18  18  18  20  25
24  41  41  28  19  19  18  19  18  18  18  18  18  18  18  18  25
24  41  41  28  19  19  19  18  18  18  18  18  18  18  18  18  25
24  21  21  21  21  21  21  21  21  21  21  21  21  21  21  21  25