15 15 15 15 15 15 15 15 15 15 15 15 15 15 15 15 15
15  0 17 17  0  1  0  8  3  9  0  0  0  0  1  0 15
15  0 17 17  1  0  1  8  2  9  0  0  1  0  0  0 15
15 10 10 10 10 10 10  4  2  6 10 10 10 10 10 10 15
15  2  3  2  3  2  3  2  3  2  3  2  3  2  3  2 15
15 11 11 11 11 11 11  5  3  7 11 11 11 11 11 11 15
15  0 12 12 12  0  1  8  3  9  1  0  0 16 16  0 15
15  1 13 13 13  1  0  8  2  9  0  0  0 16 16  0 15
15  0 14 14 14  0  0  8  3  9  0  1  0  0  0  0 15
15 15 15 15 15 15 15 15 15 15 15 15 15 15 15 15 15