-1  -1  -1  -1  -1  -1  -1  -1  -1  -1  -1  -1  -1  -1  -1  -1  -1  -1  -1  -1  -1  -1  -1  -1  -1  -1  -1  -1  -1  -1  -1  -1  -1  -1  -1  -1  -1  -1  -1  -1  -1  -1  -1  -1  -1  -1  -1  -1  -1  -1  -1  -1  -1  -1  -1  -1  -1  -1  -1  -1  -1  -1  -1  -1  -1  -1  -1  -1  -1  -1  -1  -1  -1  -1  -1  -1  -1  -1  -1  -1  -1  -1  -1  -1  -1  -1  -1  -1  -1  -1  -1  -1  -1  -1  -1  -1  -1  -1  -1  -1  -1  -1  -1  -1  -1  -1  -1  -1  -1  -1  -1  -1  -1  -1  -1  -1  -1  -1  -1  -1  -1  -1  -1  -1  -1  -1  -1  -1
-1   3   3   4   4   4   4   4   4   4  -1   1   1   1  27  30  30  30  30  30  30  26   1   1   1   1   1   1   1   1   1   1  -1  -1  -1  -1  -1  -1  -1   1   1   1   1   1   1   1   1   1   1   1   1   1   1   1   1   1   1   1   1   1   1   1   1   1   1   1   1   1   1   1   1   1   1   1   1   1   1   1   1   1   1   1   1   1   1  -1  -1  -1  -1  -1  -1  -1  -1  -1  -1  -1  -1  -1  -1  -1  -1  -1   1   1   1   1   1   1   1   1   1   1   1   1   1  13   4   4   4   4   4   4   4   4   3   4   4  -1
-1   3   4   4   4   4   4   4   4   4  -1   1   1   1  32  29  29  29  29  29  29  31   1   4   4   4   4   4   4   1   1   1  -1  -1  -1  -1  -1  -1  -1   1   1   1   9   8   8   8   8   8   8   8   8   8   8   8   8   8   8   8   8   8   8   8   8   8   8   8   8   8   8   8   8   8   8   8   8   8  11   1   1   1   3  13  13   1   1  -1  -1  29  29  29  29  29  29  29  29  29  29  29  29  -1  -1  -1   1   1   1   1   1   1   1   1   1   1   1   1   1  13   4   4   3   4   4   4   4   4   4   4   4  -1
-1   4   4   4   3   4   4   4   4   4  -1   1  13   1  32  29  29  -1  -1  29  29  31   1   1   1   1   1   1   1   1   1   1  -1  -1  -1  -1  -1  -1  -1   1   1   1   7   1   1   1   1   1   1   1   1   1   1   1   1   1   1   1   1   1   1   1   1   1   1   1   1   1   1   1   1   1   1   1   1   1   5   1   1   1   3   3   3   1   1  -1  -1  29  29  29  29  29  29  29  29  29  29  29  29  29  -1  -1   1   1  -1  -1  -1   1   1   1   1   1   1   1   1  13   4   4   4   4   3   4   4   4   4   4   4  -1
-1   4   4   4   4   4   4   4   4   4  -1   1   1   1  32  29  29  29  29  29  29  31   1   1   1   1   1   1   1   1   1   1  -1  -1  -1  -1  -1  -1  -1   1   1   1   7   1   1   1   1   1  -1  -1  -1  -1  -1  -1  -1  -1  -1  -1  -1  -1  -1  -1  -1  -1  -1  -1  -1  -1  -1  -1  -1  -1   1   1   1   1   5   1   1   1   1   1   1   1   1  -1  -1  29  29  29  -1  29  29  29  29  29  29  29  29  29  -1  -1   1   1   1   1   1   1   1   1   1   1   1   1   1   1   1   1   1   1   1   1   1   1   1   1   1  -1
-1   4   4   4   4   4   4   3   4   4  -1   1   1   1  33  28  28  28  28  28  28  34   1   9   6   6   6   6   6   6  11   1  -1  -1  -1  -1  -1  -1  -1   1   1   1   7   1   1   1   1   1  -1  -1  -1  -1  -1  -1  -1  -1  -1  -1  -1  -1  -1  -1  -1  -1  -1  -1  -1  -1  -1  -1  -1  -1   1   1   1   1  10   6   6   6   6   6   6  11   1  -1  -1  29  29  29  29  -1  29  29  29  -1  29  29  29  29  -1  -1   1   1   1   1   1   1   1   9   6   6   6   6   6   6   6   6   6   6   6   6   6   1   1   1   1  -1
-1   4   4   4   4   4   4   4   4   4  -1   1   1   1   1   1   1  13   1   1   1   1   1   7   1   1   1   1   1   1   7   1  -1  -1  -1  -1  -1  -1  -1   1   1   1   7   1   1   1   1   1   1   1   4   4   4   4   4   4   4   1   1   1   1   1   1   1   1   1   1   1   1  -1  -1  -1   1   1   1   1   1   1   1   1   1   1   1   5   1  -1  -1  29  -1  29  29  29  29  29  29  29  29  29  29  29  -1  -1   1   1   1   1   1   1   1   7   1   1   1   1   1  13   4   4   4   3   4   4   3   4   4   4   4  -1
-1   4   4   4   3   4   4   4   4   4  -1   1   1   1   1   1   1   1   1   1   1   1   1   7   1   1   1   1   1   1   7   1  -1  -1  -1  -1  -1  -1  -1   1   1   1   7   1   1   1   1   1  13   1   1   1   1   1   1   1   1   1   1   1  13   1   1   1   2   1   1   1   1  -1  -1  -1  -1  -1  -1  -1  -1  -1  -1  -1  -1  -1   1   5   1  -1  -1  29  -1  29  29  29  29  29  29  29  29  29  29  -1  -1  -1   1  27  30  30  30  26   1   7   1   1   1   1   1  13   4   4   4   4   4   4   4   4   3   4   4  -1
-1   4   4   4   4   4   4   3   4   4  -1   1   1   1   1   1   1   1   1   1   1   1   1   7   1   1   1   1   1   1   7   1  -1  -1  -1  -1  -1  -1  -1   1   1   1  10   8   8   8   8   8   8   8   8   8   8   8   8   8   8   8   8   8   8   8  11   2   2   1   1   1   1  -1  -1  -1  -1  -1  -1  -1  -1  -1  -1  -1  -1  -1   1   5   1  -1  -1  -1  -1  -1  -1  -1  -1  -1  -1  -1  -1  -1  -1  -1  -1  -1   1  32  29  29  29  31   1   7   1  -1   1   1   1   1   1   1  -1  -1  -1  -1  -1  -1  -1  -1  -1  -1
-1   4   4   4   4   4   4   4   4   4  -1   1  -1  -1  -1  -1  -1  -1  -1  -1  -1  -1   1   7   2  -1  -1  -1  -1   2   7   1  -1  -1  -1  -1  -1  -1  -1   1   1   1   1   1   1   1   1   1   1   1   1   1   1   1   1   1   1   1   1   1   1   1   5   2   2   1   1   1   1  -1  -1   2   2   2   2   2   2   2   2   2  -1  -1   1   5   1  -1  -1  -1  -1  -1  -1  -1  -1  -1  -1  -1  -1  -1  -1  -1  -1  -1   1  32  29  29  29  31   1   7   1  -1   1   1   1   1  -1   1  -1  -1  -1  -1  -1  -1  -1  -1  -1  -1
-1   4   4   4   4   4   4   4   4   4   1   1  -1  -1  -1  -1  -1  -1  -1  -1  -1  -1   1   7   2  -1  -1  -1  -1   2   7   1  -1  -1  -1  -1  -1  -1  -1  -1  -1  -1  -1  -1  -1  -1  -1  -1  -1  -1  -1  -1  -1  -1  -1  -1  -1  -1  -1  -1   1   1   5   2   2   1   1   1   1  -1  -1   2   2   2   2   2   2   2   2   2  -1  -1   1   5   1  27  30  30  30  26   1   1   1   1   1   1   1   1  -1  -1  -1  -1   1  32  29  29  29  31   1   7   1  -1   1   1   1   1  -1   1  -1  -1  -1  -1   1   1   1   1   1  -1
-1  -1  -1  -1  -1  -1  -1  -1  -1  -1  -1  -1  -1  -1  -1  -1  -1  -1  -1  -1  -1  -1   1   7   2  -1  -1  -1  -1   2   7   1  -1  -1   2   2   2   2   2   2   2   2   2   2   2   2   4   4   4   4   2   2   2   2   2   2   2  13  -1  -1   1   1   5   2   2   1   1   1   1  -1  -1   2   9   8   8   8   8   8  11   2  -1  -1   1   5   1  32  29  29  29  31   1   1   1   1   1   1   1   1  -1  -1  -1  -1   1  32  29  29  29  31   1   7   1  -1   1   1   1   1  -1   1  -1  -1  -1  -1   1  -1  -1  -1   1  -1
-1  29  31   1   1   1   1   1   1   1   1   1  -1  -1  -1  -1  -1  -1  -1  -1  -1  -1   1   7   2  -1  -1  -1  -1   2   7   1  -1  -1   2   2   2   2  13   2   2   3   3   3   3   3   4   4   4   4   3   3   2   2   2   2   2   2  -1  -1   1   1   5   2   2   1   1   1   1  -1  -1   2   7  27  30  30  30  26   7   2  -1  -1   1   5   1  32  29  29  29  31   1   1   1   1   1   1   1   1  -1  -1  -1  -1   1  32  29  29  29  31   1   7   1  -1   1   1   1   1  -1   1  -1  -1  -1  -1   1  -1  -1  -1   1  -1
-1  29  31   1   1   1   1   1   1   1   1   1  -1  -1  -1  -1  -1  -1  -1  -1  -1  -1   1   7   2  -1  -1  -1  -1   2   7   1  -1  -1   2   2  -1  -1  -1  -1  -1  -1  -1  -1  -1  -1  -1  -1  -1  -1  -1  -1  -1  -1  -1  -1   2   2  -1  -1   1   1   5   2   2   1   1   1   1  -1  -1   2   7  32  29  29  29  31   7   2  -1  -1   1   5   1  32  29  29  29  31   3   1   1   1   1   1   1   1  -1  -1  -1  -1   1  33  28  28  28  34   1   7   1  -1   1   1   1   1  -1   1  -1  -1  -1  -1   2  -1  -1  -1   1  -1
-1  28  34   1   1   1   1   1   1   1   1   9   6   6   6   6   6   6   6   6   6   6   6  12   2  -1  -1  -1  -1   2   7   1  -1  -1   2   2  -1  -1   1   1   1   1   1   1   1   1   1   1   1   1   1   1   1   1  -1  -1   2   2  -1  -1   1   1   5   2  27  30  26   1   1  -1  -1   2   7  32  29  29  29  31   7   2  -1  -1   1   5   1  32  29  29  29  31  13   4   1   1   1   1   1   1  -1  -1  -1  -1   1   1   1   1   1   1   1   7   1  -1   1   1   1   1  -1   1  -1  -1  -1  -1   2  -1  -1  -1   4  -1
-1   1   6   6   6   6   6   6   6   6   6  12   1   1   1   1   1   1   1   1   1   1   1   1   2  -1  -1  -1  -1   2   7   1  -1  -1   2   2  -1  -1   1   1   1   1   1   1   1   1   1   1   1   1   1   1   1   1  -1  -1   2   2  -1  -1   1   1   5   2  32  29  31   1   1  -1  -1   2   7  32  29  29  29  31   7   2  -1  -1   1   5   1  32  29  29  29  31   3  13   4   1   1   1   1   1  -1  -1  -1  -1   1  -1  -1  -1  -1   1   1   7   1   1   1   1   1   1  -1   1   2   2   2   2   2  -1  -1  -1  -1  -1
-1   1   1   1   1   1   1   1   1   1   1   1  -1  -1  -1  -1  -1  -1  -1  -1  -1  -1  -1  -1  -1  -1  -1  -1  -1   2   7   1  -1  -1   3   2  -1  -1   1   1   1  -1   9  11   1   1   1   1   9  11  -1   1   1   1  -1  -1   2   2  -1  -1   1   1   5   2  32  29  31   1   1  -1  -1   2   7  32  29  29  29  31   7   2  -1  -1   1   5   1  32  29  29  29  31   1   3  13   4   1   1   1   1  -1  -1  -1  -1   1   1   1   1   1   1   1   7   1   1   1   1   1   1  -1   1  -1  -1  -1  -1   2  -1  -1  -1  -1  -1
-1   1   1   1   1   1   1   1   1   1   1   1  -1   1   1   1   1   1   1   1   1   1   1   1   1   1   1   1   1   1   7   1  -1  -1   3   2  -1  -1   1   1   1   1  10  12  -1   1   1  -1  10  12   1   1   1   1  -1  -1   2   4  -1  -1   1   1   5   2  32  29  31   1   1  -1  -1   2   7  32  29  29  29  31   7   2  -1  -1   1   5   1  32  29  29  29  31   1   1   3  13   1   1   1   1  -1  -1  -1  -1   1   1   1   1   1   1   1   7   1   1   1   1   1   1  -1   1  -1  -1  -1  -1   2  -1  -1  -1  -1  -1
-1  -1  -1  -1  -1  -1  -1  -1  -1  -1  -1  -1  -1   1   9   8   8   8   8   8   8   8   8   8   8   8   8   8   8   8  12   1  -1  -1   3   2  -1  -1   1   1   1   1   1   1   1   1   1   1   1   1   1   1   1   1  -1  -1   2   4  -1  -1   1   1   5   2  32  29  31   1   1  -1  -1   2   7  32  29  13  29  31   7   2  -1  -1   1   5   1  33  28  28  28  34   1   1   1   1   1   1   1   1  -1  -1  -1  -1   1   1   1   1   4   1   1   7   1   1   4   1   1   1  -1   1  -1  -1  -1  -1   2  -1  -1  -1  13  -1
-1   4   4   4   4   4   4   4   4   4  -1   1   1   1   7   2   2   2   2   2   2   2   2   2   2   2   2   2   2   2   2   2  -1  -1   3   4  -1  -1   1   1   1   1   1   1   4   4   4   4   1   1   1   1   1   1  -1  -1   2   4  -1  -1   1   1   5   2  32  29  31   1   1  -1  -1   2   7  32  29   4  29  31   7   2  -1  -1   1  10   6   6   6   6   6   6   6   6   6   6   6  11   1   1  -1  -1  -1  -1   1   1   1   1  13   1   1   7   1   1  13   1   1   1  -1   1  -1  -1  -1  -1   2  -1  -1  -1   1  -1
-1   4   4   4   3   4   4   4   4   4  -1   1   1   1   7   2  -1  -1  -1  -1  -1  -1  -1  -1  -1  -1  -1  -1  -1  -1  -1  -1  -1  -1   3   4  -1  -1   1   1   1   1   1   1   1   1   1   1   1   1   1   1   1   1  -1  -1   3   3  -1  -1   1   1   5   2  32  29  31   1   1  -1  -1   2   7  32  29   4  29  31   7   2  -1  -1   1   2   1   1   1   1   1   1   1   1   1   1   1   7   1   1  -1  -1  -1  -1   1   1   1   1   1   1   1   7   1   1   1   1   1   1  -1   1  -1  -1  -1  -1   2  -1  -1  -1   1  -1
-1   4   4   4   4   4   4   4   4   3  -1   1   1   1   7   2  -1  -1  -1  -1  -1  -1  -1  -1  -1  -1  -1  -1  -1  -1  -1  -1  -1  -1   3   3  -1  -1   1   1  13  11   1   1   1   1   1   1   1   1   9  13   1   1  -1  -1   3   3  -1  -1   1   1   5   2  33  28  34   1   1  -1  -1   2   7  32  29   4  29  31   7   2  -1  -1   1   2   1   1   1   1   1   1   1   1   1   1   1   7   1   1  -1  -1  -1  -1   1   1   1   1   1   1   1   7   1   1   1   1   1   1  -1   1  -1  -1  -1  -1   2  -1  -1  -1   1  -1
-1   4   4   4   4   4   4   4   4   4  -1   1   1   1   7   1   1   1   1   1   1   1   1   1   1   1   1   1   1   1   1   1  -1  -1   2   3  -1  -1   1   1   1  10   6   6   6   6   6   6   6   6  12   1   1   1  -1  -1   2   4  -1  -1   1   1   5   2   2   1   1   1   1  -1  -1   2   7  32  29  13  29  31   7   2  -1  -1   1   2  27  30  30  30  26   1   1   1   1   1   1   7   1   1  -1  -1  -1  -1   1   1   1   1   4   1   1   7   1   1   4   1   1   1  -1   1  -1  -1  -1  -1   2  -1  -1  -1   1  -1
-1   3   4   4   4   4   4   4   4   4  -1   1   1   1   7   1   1   1   1   1   1   1   9   6   6   6   6   6   6   6  11   1  -1  -1   2   4  -1  -1   1   1   1   1   1   1   1   1   1   1   1   1   1   1   1   1  -1  -1   2   4  -1  -1   1   1   5   2   2   1   1   1   1  -1  -1   2   7  32  29  29  29  31   7   2  -1  -1  -1  -1  -1  -1  -1  -1  -1  -1  -1  -1  -1  -1  -1   7  -1  -1  -1  -1  -1  -1   1   1   1   1  13   1   1   7   1   1  13   1   1   1  -1   1  -1  -1  -1  -1   2  -1  -1  -1   1  -1
-1   4   4   4   4   4   4   4   4   4  -1   1   1   1   7   1   4   4   4   3   1   1   7   1  27  30  30  26   1   1   7   1  -1  -1  13   4  -1  -1   1   1   1   1   1   1   1   1   1   1   1   1   1   1   1   1  -1  -1  13   4  -1  -1   1   1   5   2  13   4   1   1   1  -1  -1   2   7  32  29  29  29  31   7   2  -1  -1  -1  -1  -1  -1  -1  -1  -1  -1  -1  -1  -1  -1  -1   7  -1  -1  -1  -1  -1  -1   1   1   1   1   1   1   1   7   1   1   1   1   1   1  -1   1  -1  -1  -1  -1   2  -1  -1  -1   1  -1
-1   4   4   4   4   3   4   4   4   4  -1   1   1   1   7   1   4   4   4   3   1   1   7   1  32  29  29  31   1   1   7   1  -1  -1   2   2  -1  -1   1   1   1   1   9   6   6   6   6   6   6  11   1   1   1   1  -1  -1   2   2  -1  -1   1   1   5   2   2   1   1   1   1  -1  -1   2   7  32  29  29  29  31   7   2  -1  -1  -1  -1  -1  -1  -1  -1  -1  -1  -1  -1  -1  -1  -1   7  -1  -1  -1  -1  -1  -1   1   1   1   1   1   1   1   7   1   1   1   1   1   1  -1   1  -1  -1  -1  -1   2  -1  -1  -1   1  -1
-1   4   4   4   4   4   4   4   4   4  -1   1   1   1   7   1   4   4   4   3   1   1   7   1  33  28  28  34   1   1   7   1  -1  -1  -1  -1  -1  -1   1   1   1   1   7   1   1   1   1   1   1   7   1   1   1   1  -1  -1  -1  -1  -1  -1   1   1   5   2   2   1   1   1   1  -1  -1   2   7  32  29  29  29  31   7   2  -1  -1  -1  -1  -1  -1  -1  -1  -1  -1  -1  -1  -1  -1  -1   7  -1  -1  -1  -1  -1  -1   1   1   1   1   1   1   1   7   1   1   1   1   1   1  -1   1  -1  -1  -1  -1   2  -1  -1  -1   1  -1
-1   4   4   4   4   4   3   4   4   4  -1   1   1   1   7   1   1   1   1   1   1   1   7   1   1  13  13   1   1   1   7   1  -1  -1  -1  -1  -1  -1   1   1   1   1   7   1   1   1   1   1   1   7   1   1   1   1  -1  -1  -1  -1  -1  -1   1   1   5   2   2   1   1   1   1  -1  -1   2   7  33  28  28  28  34   7   2  -1  -1  -1  -1  -1  -1  -1  -1  -1  -1  -1  -1  -1  -1  -1   7  -1  -1  -1  -1  -1  -1   1   1   1   1   1   1   1   7   1   1   1   1   1   1  -1   1  -1  -1  -1  -1   2  -1  -1  -1   1  -1
-1   4   4   4   4   4   4   4   4   4  -1   1   1   1   7   1   1   1   1   1   1   1   7   1   1  13  13   1   1   1   7   1   1   1   1   1   1   1   1   1   1   1   7   1   1   1   1   1   1   7   1   1   1   1   1   1   1   1   1   1   1   1   5   2   2   1   1   1   1  -1  -1   2  10   6   6   6   6   6  12   2  -1  -1   1   1   1   1   1   1   1   1   1   1   1   1   1   7   1   1   1   1   1   1   1   1   1   1   1   1   1   7   1   1   1   1   1   1  -1   1  -1  -1  -1  -1   1   1   1   1   1  -1
-1   4   4   4   4   4   4   4   4   4  -1   1   1   1  10   6   6   6   6   6   6   6  12   1   1   1   1   1   1   1  10   6   6   6   6   6   6   6   6   6   6   6  12   1   1   1   1   1   1  10   6   6   6   6   6   6   6   6   6   6   6   6  12   2   2   1   1   1   1  -1  -1   2   2   2   2   2   2   2   2   2  -1  -1   1   1  13   4   3   3   4   4  13   1   1   1   1  10   6   6   6   6   6   6   6   6   6   6   6   6   6  12   1   1   1   1   1   1  -1   1  -1  -1  -1  -1  -1  -1  -1  -1  -1  -1
-1   4   4   4   4   4   4   4   4   4  -1   1   1   1   1   1   1   1   1   1   1   1   1   1   1   1   1   1   1   1   1   1   1   1   1   1   1   1   1   1   1   1   1   1   1   1   1   1   1   1   1   1   1   1   1   1   1   1   1   1   1   1   1   1   1   1   1   1   1  -1  -1  -1  -1  -1  -1  -1  -1  -1  -1  -1  -1  -1   1   1   1   1   1   1   1   1   1   1   1   1   1   1   1   1   1   1   1   1   1   1   1   1   1   1   1   1   1   1   1   1   1   1  -1   1  -1  -1  -1  -1  -1  -1  -1  -1  -1  -1
-1  -1  -1  -1  -1  -1  -1  -1  -1  -1  -1  -1  -1  -1  -1  -1  -1  -1  -1  -1  -1  -1  -1  -1  -1  -1  -1  -1  -1  -1  -1  -1  -1  -1  -1  -1  -1  -1  -1  -1  -1  -1  -1  -1  -1  -1  -1  -1  -1  -1  -1  -1  -1  -1  -1  -1  -1  -1  -1  -1  -1  -1  -1  -1  -1  -1  -1  -1  -1  -1  -1  -1  -1  -1  -1  -1  -1  -1  -1  -1  -1  -1  -1  -1  -1  -1  -1  -1  -1  -1  -1  -1  -1  -1  -1  -1  -1  -1  -1  -1  -1  -1  -1  -1  -1  -1  -1  -1  -1  -1  -1  -1  -1  -1  -1  -1  -1  -1  -1  -1  -1  -1  -1  -1  -1  -1  -1  -1  

