24  21  22  21  23  21  21  21  22  21  23  21  21  21  22  21  25
24  18  18  18  20  18  18  18  18  18  18  18  18  18  18  18  25
24  18  18  18  20  20  18  18  18  19  18  19  18  19  18  18  25
24  18  18  18  18  18  18  18  18  18  18  18  18  18  18  18  25
24  18  18  19  19  19  18  18  18  18  18  18  18  19  18  18  25
24  18  18  18  18  19  19  18  18  18  18  18  18  18  20  18  25
24  18  18  18  18  18  18  18  18  18  18  18  18  18  18  18  25
24  18  18  18  18  18  19  18  18  18  18  18  18  18  18  18  25
24  18  18  18  18  18  18  18  18  20  18  18  19  18  18  18  25
24  18  20  18  18  20  18  18  18  18  18  18  18  18  18  19  25
24  18  20  18  18  18  18  20  18  18  18  20  18  18  18  18  25
24  18  18  18  18  18  18  18  18  18  18  18  18  18  18  18  25
24  21  21  21  21  21  21  21  21  21  21  21  21  21  21  21  25