24  21  22  21  23  21  21  21  22  21  23  21  21  21  22  21  25
24  18  18  18  20  20  18  18  18  18  20  20  20  20  20  20  25
24  18  18  18  20  20  18  18  18  19  18  20  20  20  20  20  25
24  18  18  18  36  27  27  27  27  27  27  34  20  20  20  20  25
24  18  41  19  28  19  18  32  18  32  18  28  18  20  20  20  25
24  41  41  41  28  19  30  33  18  35  29  28  18  18  20  20  25
24  18  41  18  28  18  18  18  18  18  18  28  18  20  18  20  25
24  18  41  18  28  18  36  27  27  27  34  28  18  18  18  18  25
24  18  41  18  28  18  31  18  18  20  31  28  19  18  18  18  25
24  18  20  18  35  27  29  18  18  30  27  33  18  18  18  19  25
24  20  20  18  20  20  20  20  18  18  18  20  18  18  18  18  25
24  20  20  18  20  20  20  20  20  18  18  18  18  18  18  18  25
24  21  21  21  21  21  21  21  21  21  21  21  21  21  21  21  25