-1 -1 -1 -1 -1 -1 -1 -1 -1 -1 1 -1 -1 -1 -1 -1 -1 -1 -1 -1 -1 -1 -1 1 -1 1 1 1 1 1 1 1 1 1 1 1 -1 1 1 -1 -1 -1 -1 -1 -1 -1 -1 -1 -1 -1 -1 -1 -1 -1 -1 -1 -1 -1 -1 -1 -1 -1 -1 -1
-1 29 29 31 1 1 1 1 1 -1 1 -1 1 1 1 1 1 1 1 1 1 1 -1 1 -1 1 1 1 1 1 1 1 1 1 1 1 -1 1 1 -1 1 1 1 1 1 1 1 1 1 1 1 1 1 1 1 1 1 1 1 1 1 1 1 -1
-1 29 29 31 1 1 1 1 1 -1 1 -1 1 1 1 13 1 1 1 1 1 1 -1 1 -1 1 1 1 1 4 3 1 1 1 1 1 -1 1 1 -1 1 1 1 1 1 1 1 1 1 1 1 1 1 1 1 1 1 1 1 27 30 26 1 -1
-1 28 28 34 1 1 1 1 1 -1 -1 -1 1 1 27 30 26 1 1 1 13 1 -1 -1 -1 1 1 1 1 1 1 1 1 13 1 1 -1 -1 -1 -1 1 1 1 1 1 1 13 1 1 1 1 1 1 1 1 1 13 3 1 32 29 31 1 -1
-1 4 4 4 1 1 1 1 9 6 6 6 11 1 33 28 34 9 8 6 6 11 1 1 1 9 6 6 6 11 1 1 1 1 1 1 1 1 9 6 6 6 6 6 6 6 6 6 6 6 6 6 6 6 11 1 1 1 1 33 28 34 1 -1
-1 6 6 6 8 8 6 6 12 1 1 1 10 8 6 8 8 12 1 1 1 10 8 8 6 12 27 30 26 10 6 6 6 6 6 6 6 6 12 1 1 1 1 1 1 1 1 1 1 1 9 6 6 11 7 1 1 1 1 1 1 1 1 -1
-1 3 3 4 3 1 1 1 1 -1 -1 -1 1 1 1 1 1 1 1 1 1 1 -1 -1 -1 1 32 29 31 1 1 1 1 1 1 1 -1 -1 -1 -1 1 27 30 30 30 26 1 1 1 1 5 1 10 12 7 1 1 1 1 1 13 13 1 -1
-1 1 1 1 1 1 1 27 30 -1 1 -1 1 13 1 1 1 1 1 1 27 30 -1 1 -1 1 32 29 31 1 1 1 1 1 1 1 -1 1 1 -1 1 33 28 28 28 34 3 1 1 1 10 8 8 8 12 1 1 1 1 1 13 13 1 -1
-1 1 1 1 1 1 1 32 29 -1 1 -1 1 1 1 1 1 1 1 1 32 29 -1 1 -1 1 33 28 34 1 13 1 1 3 4 1 -1 1 1 -1 1 1 1 1 1 1 1 1 1 1 1 1 1 1 1 1 1 1 1 1 1 1 1 -1
-1 -1 -1 -1 -1 -1 -1 -1 -1 -1 1 -1 -1 -1 -1 -1 -1 -1 -1 -1 -1 -1 -1 1 -1 1 1 1 1 1 1 1 1 1 1 1 -1 1 1 -1 -1 -1 -1 -1 -1 -1 -1 -1 -1 -1 -1 -1 -1 -1 -1 -1 -1 -1 -1 -1 -1 -1 -1 -1
