
0 0 0 0 0 0 0 0 0 0 0 0 0 0 0 0 0 0 0 0 0 0 0 0 0 0 0 0 0 0 0 0 0 0 0 -24 -23 -23 -21 -22 -22 -22 -21 -21 -23 -25 0 0 0 0 0 0 0 0 0 0 0 0 0 0 0 0 0 0 0 0 0 0 0 0 0 0 0 0 0 0 0 0 0 0 0 0 0 0 0 0 0 0 0 0 0 0 0 0 0 0 0 0 0 0 0 0 0 0 0 0 0 0 0 0 0 0 0 0 0 0 0 0 0 0 0 0 0 0 0 0 0 0 0 0 0 0 0 0 0 0 0 0 0 0 0 0 0
0 -24 -21 -21 -23 -21 -22 -22 -22 -21 -21 -21 -46 0 0 0 0 0 0 0 0 0 0 0 0 0 0 0 0 0 0 0 0 0 0 -24 -45 -45 -18 -18 -18 -20 -20 -20 -20 -25 0 0 0 0 0 0 0 0 0 0 0 0 0 0 0 0 0 0 0 0 0 0 0 0 0 0 0 0 0 0 0 0 0 0 0 0 0 0 0 0 0 0 0 0 0 0 0 0 0 0 0 0 0 0 0 0 0 0 0 0 0 0 0 0 0 0 0 0 0 0 0 0 0 0 0 0 0 0 0 0 0 0 0 0 0 0 0 0 0 0 0 0 0 0 0 0 0
0 -24 -41 -44 -19 -18 -18 -18 -18 -18 -18 -18 -18 -21 -23 -23 -21 -21 -22 -22 -21 -21 -21 -23 -23 -21 -25 0 0 0 0 0 0 0 0 -24 -45 -18 -18 -18 -20 -18 -18 -20 -20 -25 0 0 0 0 0 0 0 0 0 0 0 0 0 0 0 0 0 0 0 0 0 0 0 0 0 0 0 0 0 0 0 0 0 0 0 0 0 0 0 0 0 0 0 0 0 0 0 0 0 0 0 0 0 0 0 0 0 0 0 0 0 0 0 0 0 0 0 0 0 0 0 0 0 0 0 0 0 0 0 0 0 0 0 0 0 0 0 0 0 0 0 0 0 0 0 0 0
0 -24 -44 -19 -19 -19 -18 -18 -18 -18 -18 -19 -19 -18 -19 -19 -18 -18 -18 -18 -18 -18 -18 -18 -45 -45 -25 0 0 0 0 0 0 0 0 -24 -18 -18 -18 -18 -18 -18 -20 -18 -20 -25 0 0 0 0 0 0 0 0 0 0 0 0 0 0 0 0 0 0 0 0 0 0 0 0 0 0 0 0 0 0 0 0 0 0 0 0 0 0 0 0 0 0 0 0 0 0 0 0 0 0 0 0 0 0 0 0 0 0 0 0 0 0 0 0 0 0 0 0 0 0 0 0 0 0 0 0 0 0 0 0 0 0 0 0 0 0 0 0 0 0 0 0 0 0 0 0 0
0 -24 -18 -19 -19 -19 -36 -27 -34 -18 -18 -18 -19 -18 -19 -19 -19 -18 -18 -18 -18 -18 -18 -18 -19 -19 -23 -21 -21 -21 -22 -22 -23 -23 -21 -21 -18 -18 -18 -18 -18 -18 -18 -18 -18 -25 0 0 0 0 0 0 0 0 0 0 0 0 0 0 0 0 0 0 0 0 0 0 0 0 0 0 0 0 0 0 0 0 0 0 0 0 0 0 0 0 0 0 0 0 0 0 0 0 0 0 0 0 0 0 0 0 0 0 0 0 0 0 0 0 0 0 0 0 0 0 0 0 0 0 0 0 0 0 0 0 0 0 0 0 0 0 0 0 0 0 0 0 0 0 0 0 0
0 -24 -18 -19 -19 -18 -28 -45 -28 -19 -19 -19 -19 -18 -18 -19 -19 -19 -19 -19 -18 -18 -18 -18 -19 -19 -18 -18 -18 -18 -18 -18 -18 -18 -18 -18 -18 -18 -18 -18 -18 -18 -18 -18 -18 -25 0 0 0 0 0 0 0 0 0 0 0 0 0 0 0 0 0 0 0 0 0 0 0 0 0 0 0 0 0 0 0 0 0 0 0 0 0 0 0 0 0 0 0 0 0 0 0 0 0 0 0 0 0 0 0 0 0 0 0 0 0 0 0 0 0 0 0 0 0 0 0 0 0 0 0 0 0 0 0 0 0 0 0 0 0 0 0 0 0 0 0 0 0 0 0 0 0
0 -24 -18 -18 -18 -18 -28 -41 -28 -43 -19 -19 -19 -18 -18 -19 -19 -19 -18 -18 -44 -44 -18 -18 -19 -18 -18 -18 -18 -18 -18 -18 -18 -18 -18 -18 -18 -18 -18 -18 -18 -18 -18 -18 -18 -25 0 0 0 0 0 0 0 0 0 0 0 0 0 0 0 0 0 0 0 0 0 0 0 0 0 0 0 0 0 0 0 0 0 0 0 0 0 0 0 0 0 0 0 0 0 0 0 0 0 0 0 0 0 0 0 0 0 0 0 0 0 0 0 0 0 0 0 0 0 0 0 0 0 0 0 0 0 0 0 0 0 0 0 0 0 0 0 0 0 0 0 0 0 0 0 0 0
0 -24 -18 -18 -18 -18 -28 -41 -28 -43 -19 -19 -18 -18 -18 -18 -19 -19 -18 -18 -44 -18 -18 -19 -19 -18 -47 -21 -21 -21 -21 -21 -21 -21 -21 -46 -18 -18 -18 -18 -45 -45 -18 -18 -18 -25 0 0 0 0 0 0 0 0 0 0 0 0 0 0 0 0 0 0 0 0 0 0 0 0 0 0 0 0 0 0 0 0 0 0 0 0 0 0 0 0 0 0 0 0 0 0 0 0 0 0 0 0 0 0 0 0 0 0 0 0 0 0 0 0 0 0 0 0 0 0 0 0 0 0 0 0 0 0 0 0 0 0 0 0 0 0 0 0 0 0 0 0 0 0 0 0 0
0 -24 -46 -18 -18 -18 -28 -41 -28 -18 -18 -18 -18 -18 -45 -18 -18 -18 -18 -18 -19 -18 -18 -18 -18 -43 -25 0 0 0 0 0 0 0 0 -24 -18 -18 -18 -18 -45 -45 -18 -18 -18 -25 0 0 0 0 0 0 0 -24 -21 -21 -42 -42 -42 -21 -21 -42 -42 -21 -21 -42 -42 -42 -42 -42 -42 -42 -42 -25 0 0 0 0 0 0 0 0 0 0 0 0 0 0 0 0 0 0 0 0 0 0 0 0 0 0 0 0 0 0 0 0 0 0 0 0 0 0 0 0 0 0 0 0 0 0 0 0 0 0 0 0 0 0 0 0 0 0 0 0 0 0 0 0 0 0 0 0 0
0 0 -24 -18 -19 -18 -28 -45 -28 -18 -18 -18 -47 -21 -21 -21 -21 -46 -18 -18 -19 -18 -18 -19 -18 -47 -25 0 0 0 0 0 0 0 0 -24 -18 -18 -18 -18 -18 -18 -18 -18 -18 -25 0 0 0 0 0 0 0 -24 -45 -18 -18 -20 -20 -18 -18 -20 -18 -18 -18 -18 -20 -18 -20 -20 -18 -18 -41 -25 0 0 0 0 0 0 0 0 0 0 0 0 0 0 0 0 0 0 0 0 0 0 0 0 0 0 0 0 0 0 0 0 0 0 0 0 0 0 0 0 0 0 0 0 0 0 0 0 0 0 0 0 0 0 0 0 0 0 0 0 0 0 0 0 0 0 0 0 0
0 0 -24 -18 -19 -18 -35 -27 -33 -18 -18 -18 -25 0 0 0 0 -24 -44 -19 -19 -19 -19 -19 -18 -25 0 0 0 0 0 0 0 0 0 -24 -18 -18 -18 -18 -18 -18 -18 -18 -18 -25 0 0 0 0 0 0 0 -47 -45 -18 -18 -20 -20 -18 -18 -20 -19 -19 -19 -19 -20 -20 -20 -19 -18 -18 -18 -46 0 0 0 0 0 0 0 0 0 0 0 0 0 0 0 0 0 0 0 0 0 0 0 0 0 0 0 0 0 0 0 0 0 0 0 0 0 0 0 0 0 0 0 0 0 0 0 0 0 0 0 0 0 0 0 0 0 0 0 0 0 0 0 0 0 0 0 0 0
0 0 -24 -18 -18 -18 -18 -18 -18 -19 -19 -18 -25 0 0 0 0 -24 -44 -19 -19 -19 -19 -18 -18 -25 0 0 0 0 0 0 0 0 0 -24 -45 -18 -18 -19 -19 -19 -18 -18 -18 -25 0 0 0 0 0 0 -24 -45 -18 -18 -20 -18 -18 -18 -18 -18 -20 -20 -18 -18 -20 -18 -20 -19 -20 -18 -18 -41 -25 0 0 0 0 0 0 0 0 0 0 0 0 0 0 0 0 0 0 0 0 0 0 0 0 0 0 0 0 0 0 0 0 0 0 0 0 0 0 0 0 0 0 0 0 0 0 0 0 0 0 0 0 0 0 0 0 0 0 0 0 0 0 0 0 0 0 0 0
0 0 -24 -18 -19 -19 -19 -19 -18 -19 -19 -19 -25 0 0 0 0 -24 -19 -18 -18 -19 -19 -18 -18 -25 0 0 0 0 0 0 0 0 0 -24 -45 -45 -18 -19 -19 -19 -18 -18 -18 -25 0 0 0 0 0 0 -47 -18 -18 -19 -19 -20 -19 -18 -18 -20 -18 -20 -18 -18 -20 -20 -18 -18 -20 -18 -18 -18 -46 0 0 0 0 0 0 0 0 0 0 0 0 0 0 0 0 0 0 0 0 0 0 0 0 0 0 0 0 0 0 0 0 0 0 0 0 0 0 0 0 0 0 0 0 0 0 0 0 0 0 0 0 0 0 0 0 0 0 0 0 0 0 0 0 0 0 0 0
0 0 -24 -18 -18 -19 -19 -19 -18 -18 -18 -43 -25 0 0 0 0 -24 -19 -19 -18 -18 -19 -18 -18 -25 0 0 0 0 0 0 0 0 0 -24 -45 -45 -18 -19 -19 -19 -18 -18 -18 -25 0 0 0 0 0 -24 -18 -18 -19 -19 -18 -18 -18 -18 -18 -18 -18 -20 -18 -18 -18 -18 -18 -18 -19 -19 -18 -18 -18 -25 0 0 0 0 0 0 0 0 0 0 0 0 0 0 0 0 -24 -21 -21 -21 -22 -22 -22 -21 -21 -21 -22 -22 -22 -21 -21 -21 -21 -21 -21 -22 -22 -22 -21 -21 -21 -22 -22 -22 -21 -21 -25 0 0 0 0 0 0 0 0 0 0 0 0 0 0 0 0 0 0 0 0
0 0 -24 -21 -21 -46 -18 -18 -18 -47 -21 -21 -25 0 0 0 0 -24 -27 -34 -18 -18 -19 -18 -18 -25 0 0 0 0 0 0 0 0 0 -24 -18 -18 -45 -19 -19 -19 -18 -18 -18 -25 0 0 0 0 0 -47 -18 -18 -19 -18 -18 -18 -18 -36 -27 -29 -18 -18 -18 -30 -27 -34 -18 -18 -18 -19 -18 -18 -18 -46 0 0 0 0 0 0 0 0 0 0 0 0 0 0 0 0 -24 -18 -18 -18 -18 -18 -18 -18 -18 -18 -18 -18 -18 -18 -41 -45 -18 -18 -18 -18 -18 -18 -18 -18 -18 -18 -18 -18 -18 -18 -25 0 0 0 0 0 0 0 0 0 0 0 0 0 0 0 0 0 0 0 0
0 0 0 0 0 -24 -18 -18 -18 -25 0 0 0 0 0 0 0 -24 -41 -28 -18 -19 -19 -19 -45 -25 0 0 0 0 0 0 0 0 0 -24 -18 -18 -18 -19 -19 -19 -18 -18 -18 -25 0 0 0 0 -47 -18 -18 -18 -18 -18 -18 -18 -36 -33 -18 -18 -18 -20 -18 -18 -18 -35 -34 -18 -18 -18 -18 -18 -18 -18 -46 0 0 0 0 0 0 0 0 0 0 0 0 0 0 0 -24 -18 -18 -18 -18 -18 -18 -18 -18 -18 -18 -18 -18 -18 -41 -45 -18 -18 -18 -18 -18 -18 -18 -18 -18 -18 -18 -18 -18 -18 -25 0 0 0 0 0 0 0 0 0 0 0 0 0 0 0 0 0 0 0 0
0 0 0 0 0 -24 -18 -18 -18 -25 0 0 0 0 0 0 0 -24 -23 -23 -46 -18 -19 -18 -47 -25 0 0 0 0 0 0 0 0 0 -24 -18 -18 -18 -19 -19 -19 -18 -18 -18 -21 -21 -23 -21 -23 -18 -18 -18 -18 -18 -18 -18 -36 -33 -18 -18 -18 -18 -18 -18 -18 -18 -41 -35 -34 -18 -18 -18 -18 -18 -18 -18 -21 -21 -21 -21 -21 -21 -21 -21 -21 -21 -21 -21 -21 -21 -21 -21 -18 -18 -18 -18 -18 -18 -18 -18 -18 -18 -18 -18 -18 -45 -32 -18 -18 -18 -18 -18 -19 -19 -19 -19 -18 -18 -18 -18 -18 -25 0 0 0 0 0 0 0 0 0 0 0 0 0 0 0 0 0 0 0 0
0 0 0 0 0 -24 -18 -18 -18 -25 0 0 0 0 0 0 0 0 0 0 -24 -18 -18 -18 -25 0 0 0 0 0 0 0 0 0 0 -24 -18 -18 -18 -19 -19 -19 -18 -18 -18 -18 -18 -18 -18 -18 -18 -18 -18 -18 -18 -18 -36 -33 -45 -18 -18 -20 -20 -20 -20 -20 -18 -18 -18 -35 -34 -18 -18 -18 -18 -18 -18 -18 -18 -18 -18 -18 -18 -18 -18 -18 -18 -18 -18 -18 -18 -18 -18 -18 -18 -18 -18 -18 -18 -18 -19 -19 -18 -18 -18 -18 -45 -28 -18 -18 -18 -19 -19 -19 -18 -18 -19 -18 -18 -18 -18 -18 -25 0 0 0 0 0 0 0 0 0 0 0 0 0 0 0 0 0 0 0 0
0 0 0 0 0 -24 -18 -18 -18 -25 0 0 0 0 0 0 0 0 0 0 -24 -18 -18 -18 -25 0 0 0 0 0 0 0 0 0 0 -24 -18 -18 -18 -19 -19 -19 -18 -18 -18 -18 -18 -18 -18 -18 -18 -18 -18 -18 -18 -36 -33 -45 -18 -18 -20 -20 -20 -20 -20 -20 -20 -18 -18 -18 -35 -34 -18 -18 -18 -18 -18 -18 -18 -18 -18 -18 -18 -18 -18 -18 -18 -18 -18 -18 -18 -18 -18 -18 -18 -18 -18 -18 -19 -18 -19 -19 -18 -18 -18 -18 -45 -28 -18 -18 -18 -18 -18 -18 -18 -18 -19 -18 -18 -18 -18 -18 -25 0 0 0 0 0 0 0 0 0 0 0 0 0 0 0 0 0 0 0 0
0 -24 -42 -42 -42 -42 -18 -18 -18 -42 -42 -42 -42 -25 0 0 0 0 0 0 -24 -18 -18 -19 -25 0 0 0 0 0 0 0 0 0 0 -24 -18 -18 -18 -19 -19 -19 -18 -18 -30 -27 -27 -27 -27 -27 -27 -27 -27 -27 -27 -39 -41 -41 -18 -18 -20 -20 -20 -20 -20 -20 -20 -18 -18 -18 -18 -40 -27 -27 -27 -27 -27 -27 -27 -27 -27 -27 -29 -18 -18 -18 -18 -18 -18 -18 -18 -18 -18 -18 -18 -18 -18 -18 -19 -18 -19 -19 -18 -18 -18 -18 -45 -31 -18 -18 -18 -18 -18 -18 -18 -19 -19 -18 -18 -18 -18 -18 -25 0 0 0 0 0 0 0 0 0 0 0 0 0 0 0 0 0 0 0 0
0 -24 -20 -18 -18 -18 -20 -20 -20 -18 -18 -18 -18 -25 0 0 0 0 0 0 -24 -18 -18 -19 -25 0 0 0 0 0 0 0 0 0 0 -24 -18 -18 -18 -19 -19 -19 -18 -18 -18 -18 -18 -18 -18 -18 -18 -18 -18 -18 -18 -35 -34 -18 -18 -18 -20 -20 -20 -20 -20 -20 -20 -18 -18 -18 -36 -33 -18 -18 -18 -18 -18 -18 -18 -18 -18 -18 -18 -18 -18 -18 -18 -18 -18 -18 -18 -18 -18 -18 -18 -18 -18 -18 -19 -18 -19 -19 -18 -18 -18 -18 -45 -45 -18 -18 -18 -19 -19 -19 -19 -19 -18 -18 -19 -18 -18 -18 -25 0 0 0 0 0 0 0 0 0 0 0 0 0 0 0 0 0 0 0 0
0 -24 -18 -18 -18 -20 -20 -20 -20 -20 -18 -20 -18 -25 0 0 0 0 0 0 -24 -18 -19 -18 -25 0 0 0 0 0 0 0 0 0 0 -24 -18 -18 -18 -18 -18 -19 -18 -18 -18 -18 -18 -18 -18 -18 -18 -18 -18 -18 -18 -20 -35 -34 -18 -18 -18 -20 -20 -20 -20 -20 -18 -18 -18 -36 -33 -18 -18 -18 -18 -18 -18 -18 -18 -18 -18 -18 -18 -18 -18 -18 -18 -18 -18 -18 -18 -18 -18 -18 -18 -18 -18 -18 -19 -18 -19 -19 -18 -18 -18 -18 -41 -45 -18 -18 -18 -18 -18 -18 -20 -20 -20 -18 -19 -19 -19 -18 -25 0 0 0 0 0 0 0 0 0 0 0 0 0 0 0 0 0 0 0 0
0 -24 -18 -18 -20 -20 -20 -20 -20 -20 -20 -18 -18 -25 0 0 0 0 0 0 -24 -18 -19 -18 -25 0 0 0 0 0 0 0 0 0 0 -24 -18 -18 -19 -19 -18 -19 -18 -18 -18 -47 -21 -21 -21 -46 -18 -18 -18 -18 -18 -18 -20 -35 -34 -18 -20 -18 -18 -18 -18 -18 -18 -18 -36 -39 -18 -18 -18 -18 -18 -18 -18 -47 -21 -21 -21 -21 -21 -21 -21 -21 -21 -21 -21 -21 -21 -21 -46 -18 -18 -18 -18 -18 -19 -18 -19 -19 -18 -18 -18 -18 -45 -45 -18 -18 -18 -18 -18 -20 -20 -32 -20 -20 -19 -19 -19 -18 -25 0 0 0 0 0 0 0 0 0 0 0 0 0 0 0 0 0 0 0 0
0 -24 -20 -18 -20 -20 -20 -20 -20 -20 -20 -18 -20 -25 0 0 0 0 0 0 -24 -18 -19 -20 -25 0 0 0 0 0 0 0 0 0 0 -24 -18 -18 -19 -19 -18 -19 -18 -18 -45 -25 0 0 0 -24 -21 -46 -18 -19 -19 -18 -18 -18 -35 -34 -18 -20 -18 -18 -18 -18 -45 -36 -33 -18 -18 -18 -19 -18 -18 -47 -21 -25 0 0 0 0 0 0 0 0 0 0 0 0 0 0 -24 -18 -18 -18 -18 -18 -19 -18 -19 -19 -18 -18 -18 -18 -45 -45 -18 -18 -18 -18 -18 -20 -30 -26 -29 -20 -19 -19 -19 -18 -25 0 0 0 0 0 0 0 0 0 0 0 0 0 0 0 0 0 0 0 0
0 -24 -18 -20 -18 -20 -20 -20 -20 -20 -18 -18 -18 -25 0 0 0 0 0 0 -24 -18 -19 -20 -25 0 0 0 0 0 0 0 0 0 0 -24 -18 -18 -19 -19 -18 -19 -18 -18 -45 -25 0 0 0 0 0 -24 -18 -18 -19 -19 -18 -18 -18 -35 -27 -29 -18 -18 -18 -30 -27 -39 -18 -18 -18 -18 -19 -18 -18 -25 0 0 0 0 0 0 0 0 0 0 0 0 0 0 0 0 -24 -18 -18 -18 -18 -18 -19 -18 -19 -19 -18 -18 -18 -18 -32 -45 -18 -18 -18 -18 -18 -20 -20 -28 -20 -20 -19 -19 -19 -18 -25 0 0 0 0 0 0 0 0 0 0 0 0 0 0 0 0 0 0 0 0
0 -24 -18 -18 -18 -18 -20 -20 -20 -18 -18 -20 -18 -25 0 0 0 0 0 0 -24 -18 -19 -20 -25 0 0 0 0 0 0 0 0 0 0 -24 -18 -18 -19 -19 -19 -18 -18 -18 -45 -25 0 0 0 0 0 -24 -18 -18 -19 -19 -19 -18 -18 -18 -20 -20 -18 -18 -18 -18 -18 -18 -18 -18 -18 -18 -18 -18 -18 -25 0 0 0 0 0 0 0 0 0 0 0 0 0 0 0 0 -24 -18 -18 -18 -18 -18 -19 -18 -19 -19 -18 -18 -18 -18 -28 -45 -18 -18 -18 -18 -18 -18 -20 -28 -20 -19 -18 -18 -18 -18 -25 0 0 0 0 0 0 0 0 0 0 0 0 0 0 0 0 0 0 0 0
0 -24 -42 -42 -42 -46 -18 -18 -18 -47 -42 -42 -42 -25 0 0 0 0 0 0 -24 -18 -19 -18 -25 0 0 0 0 0 0 0 0 0 0 -24 -18 -18 -19 -19 -19 -18 -18 -18 -18 -25 0 0 0 0 0 -24 -18 -18 -19 -18 -19 -18 -18 -18 -18 -18 -18 -18 -18 -18 -18 -18 -19 -19 -19 -18 -18 -18 -18 -25 0 0 0 0 0 0 0 0 0 0 0 0 0 0 0 0 -24 -18 -18 -18 -18 -18 -19 -18 -19 -19 -18 -18 -18 -18 -28 -45 -18 -18 -18 -18 -18 -18 -20 -28 -20 -19 -18 -18 -18 -18 -25 0 0 0 0 0 0 0 0 0 0 0 0 0 0 0 0 0 0 0 0
0 0 0 0 0 -24 -18 -18 -18 -25 0 0 0 0 0 0 0 0 0 0 -24 -18 -19 -18 -25 0 0 0 0 0 0 0 0 0 0 -24 -18 -18 -19 -19 -19 -18 -18 -18 -18 -25 0 0 0 0 0 -24 -18 -18 -19 -18 -19 -18 -18 -18 -45 -18 -18 -18 -18 -18 -18 -18 -19 -18 -18 -18 -18 -18 -18 -25 0 0 0 0 0 0 0 0 0 0 0 0 0 0 0 0 -24 -18 -18 -18 -18 -18 -19 -18 -19 -18 -18 -18 -18 -18 -31 -45 -18 -18 -18 -18 -18 -18 -20 -31 -20 -19 -18 -18 -18 -18 -25 0 0 0 0 0 0 0 0 0 0 0 0 0 0 0 0 0 0 0 0
0 0 0 0 0 -24 -18 -18 -18 -25 0 0 0 0 0 0 0 0 0 0 -24 -18 -19 -18 -25 0 0 0 0 0 0 0 0 0 0 -24 -18 -18 -19 -19 -19 -18 -18 -18 -18 -25 0 0 0 0 0 -24 -45 -18 -19 -19 -19 -18 -18 -18 -18 -18 -18 -18 -18 -18 -18 -18 -19 -18 -18 -18 -18 -18 -18 -25 0 0 0 0 0 0 0 0 0 0 0 0 0 0 0 0 -24 -18 -18 -18 -18 -18 -19 -19 -19 -18 -18 -18 -18 -18 -45 -45 -18 -18 -18 -18 -18 -19 -20 -20 -20 -19 -19 -19 -18 -18 -25 0 0 0 0 0 0 0 0 0 0 0 0 0 0 0 0 0 0 0 0
0 0 0 0 0 -24 -18 -19 -18 -25 0 0 0 0 0 0 0 0 0 0 -24 -18 -19 -19 -25 0 0 0 0 0 0 0 0 0 0 -24 -18 -18 -19 -19 -19 -18 -18 -18 -18 -25 0 0 0 0 0 -24 -45 -45 -18 -18 -18 -18 -18 -18 -18 -18 -18 -18 -18 -18 -18 -18 -18 -18 -18 -18 -18 -41 -18 -25 0 0 0 0 0 0 0 0 0 0 0 0 0 0 0 0 -24 -18 -18 -18 -18 -18 -19 -19 -18 -18 -18 -18 -18 -18 -45 -41 -18 -18 -18 -18 -18 -19 -18 -18 -18 -19 -18 -19 -18 -18 -25 0 0 0 0 0 0 0 0 0 0 0 0 0 0 0 0 0 0 0 0
0 0 0 0 0 -24 -20 -19 -18 -25 0 0 0 0 0 0 0 0 0 0 -24 -18 -18 -18 -25 0 0 0 0 0 0 0 0 0 0 -24 -18 -18 -19 -18 -18 -18 -18 -18 -18 -25 0 0 0 0 0 -24 -45 -45 -45 -18 -18 -18 -18 -18 -18 -18 -18 -18 -18 -18 -18 -18 -18 -18 -18 -18 -41 -41 -41 -25 0 0 0 0 0 0 0 0 0 0 0 0 0 0 0 0 -24 -18 -18 -18 -18 -20 -20 -20 -18 -18 -18 -18 -18 -18 -45 -41 -18 -18 -18 -18 -18 -19 -18 -18 -18 -19 -18 -19 -18 -18 -25 0 0 0 0 0 0 0 0 0 0 0 0 0 0 0 0 0 0 0 0
-24 -21 -23 -23 -22 -22 -18 -18 -18 -21 -21 -21 -22 -22 -23 -23 -21 -21 -21 -21 -21 -18 -18 -18 -21 -21 -21 -23 -22 -22 -23 -23 -21 -21 -22 -22 -20 -18 -19 -18 -18 -18 -18 -18 -18 -25 0 0 0 0 0 -24 -21 -21 -21 -21 -21 -21 -21 -21 -21 -21 -21 -21 -21 -21 -21 -21 -21 -21 -21 -21 -21 -21 -21 -25 0 0 0 0 0 0 0 0 0 0 0 0 0 0 0 0 -24 -18 -18 -18 -20 -20 -32 -20 -20 -18 -18 -18 -18 -18 -45 -45 -18 -18 -18 -18 -19 -19 -18 -18 -18 -20 -18 -19 -18 -18 -25 0 0 0 0 0 0 0 0 0 0 0 0 0 0 0 0 0 0 0 0
-24 -20 -20 -20 -20 -20 -18 -18 -18 -18 -18 -18 -18 -18 -18 -18 -18 -18 -18 -18 -18 -18 -18 -18 -18 -18 -18 -18 -18 -18 -18 -18 -18 -20 -20 -20 -20 -18 -19 -18 -18 -18 -18 -18 -18 -25 0 0 0 0 0 0 0 0 0 0 0 0 0 0 0 0 0 0 0 0 0 0 0 0 0 0 0 0 0 0 0 0 0 0 0 0 0 0 0 0 0 0 0 0 0 0 -24 -18 -18 -19 -20 -30 -26 -29 -20 -18 -18 -18 -18 -18 -45 -32 -18 -18 -18 -18 -19 -18 -18 -18 -18 -19 -18 -19 -18 -18 -25 0 0 0 0 0 0 0 0 0 0 0 0 0 0 0 0 0 0 0 0
-24 -18 -20 -20 -18 -18 -18 -18 -18 -18 -18 -18 -18 -18 -18 -18 -18 -18 -18 -20 -18 -18 -18 -18 -18 -18 -18 -18 -19 -19 -19 -18 -18 -18 -19 -18 -18 -20 -19 -18 -18 -18 -18 -18 -18 -25 0 0 0 0 0 0 0 0 0 0 0 0 0 0 0 0 0 0 0 0 0 0 0 0 0 0 0 0 0 0 0 0 0 0 0 0 0 0 0 0 0 0 0 0 0 0 -24 -18 -18 -19 -20 -20 -28 -20 -20 -18 -18 -18 -18 -18 -45 -28 -18 -18 -18 -18 -19 -18 -19 -19 -18 -19 -18 -19 -18 -18 -25 0 0 0 0 0 0 0 0 0 0 0 0 0 0 0 0 0 0 0 0
-24 -20 -18 -18 -20 -18 -18 -18 -18 -18 -18 -18 -18 -18 -18 -18 -18 -18 -18 -18 -18 -18 -18 -18 -18 -18 -18 -18 -19 -19 -19 -19 -19 -18 -19 -18 -18 -18 -19 -18 -18 -18 -18 -18 -18 -25 0 0 0 0 0 0 0 0 0 0 0 0 0 0 0 0 0 0 0 0 0 0 0 0 0 0 0 0 0 0 0 0 0 0 0 0 0 0 0 0 0 0 0 0 0 0 -24 -18 -18 -19 -18 -20 -28 -20 -18 -18 -18 -18 -18 -18 -45 -28 -18 -18 -18 -19 -19 -18 -19 -19 -18 -19 -18 -19 -18 -18 -25 0 0 0 0 0 0 0 0 0 0 0 0 0 0 0 0 0 0 0 0
-24 -18 -18 -18 -19 -19 -19 -18 -18 -18 -18 -18 -18 -45 -18 -20 -18 -18 -18 -18 -18 -18 -18 -20 -18 -18 -18 -18 -45 -19 -19 -19 -19 -18 -18 -18 -18 -18 -19 -18 -18 -18 -18 -18 -18 -25 0 0 0 0 0 0 0 0 0 0 0 0 0 0 0 0 0 0 0 0 0 0 0 0 0 0 0 0 0 0 0 0 0 0 0 0 0 0 0 0 0 0 0 0 0 0 -24 -18 -18 -19 -18 -20 -28 -20 -18 -18 -18 -18 -18 -18 -45 -31 -18 -18 -19 -19 -18 -18 -19 -19 -18 -19 -19 -18 -18 -18 -25 0 0 0 0 0 0 0 0 0 0 0 0 0 0 0 0 0 0 0 0
-24 -18 -18 -18 -19 -19 -18 -18 -18 -18 -18 -45 -45 -45 -19 -19 -19 -20 -19 -20 -20 -20 -19 -19 -19 -19 -19 -19 -45 -45 -45 -19 -19 -19 -19 -19 -19 -18 -18 -18 -18 -18 -18 -18 -20 -25 0 0 0 0 0 0 0 0 0 0 0 0 0 0 0 0 0 0 0 0 0 0 0 0 0 0 0 0 0 0 0 0 0 0 0 0 0 0 0 0 0 0 0 0 0 0 -24 -18 -18 -19 -18 -20 -31 -20 -18 -18 -18 -18 -18 -18 -45 -45 -18 -18 -19 -18 -18 -18 -19 -19 -18 -19 -19 -18 -18 -18 -25 0 0 0 0 0 0 0 0 0 0 0 0 0 0 0 0 0 0 0 0
-24 -18 -18 -18 -18 -19 -19 -19 -19 -18 -18 -45 -19 -19 -19 -18 -18 -18 -18 -18 -18 -20 -18 -18 -18 -18 -18 -18 -18 -18 -45 -18 -18 -18 -18 -18 -18 -18 -18 -18 -18 -18 -18 -20 -20 -25 0 0 0 0 0 0 0 0 0 0 0 0 0 0 0 0 0 0 0 0 0 0 0 0 0 0 0 0 0 0 0 0 0 0 0 0 0 0 0 0 0 0 0 0 0 0 -24 -18 -18 -19 -18 -20 -20 -20 -18 -18 -18 -18 -18 -18 -45 -45 -18 -18 -18 -19 -18 -18 -19 -19 -18 -18 -19 -18 -18 -18 -25 0 0 0 0 0 0 0 0 0 0 0 0 0 0 0 0 0 0 0 0
-24 -18 -18 -18 -18 -18 -19 -19 -19 -19 -19 -18 -18 -18 -18 -19 -19 -19 -19 -19 -19 -18 -18 -18 -18 -18 -18 -18 -18 -18 -18 -18 -18 -18 -18 -18 -18 -18 -18 -18 -20 -18 -20 -20 -20 -25 0 0 0 0 0 0 0 0 0 0 0 0 0 0 0 0 0 0 0 0 0 0 0 0 0 0 0 0 0 0 0 0 0 0 0 0 0 0 0 0 0 0 0 0 0 0 -24 -18 -18 -19 -18 -19 -18 -19 -18 -18 -18 -18 -18 -18 -45 -45 -18 -18 -18 -19 -18 -18 -19 -18 -18 -18 -19 -18 -18 -18 -25 0 0 0 0 0 0 0 0 0 0 0 0 0 0 0 0 0 0 0 0
-24 -18 -18 -18 -18 -18 -18 -18 -18 -18 -18 -18 -18 -18 -18 -18 -18 -18 -18 -18 -18 -18 -18 -18 -18 -18 -18 -18 -18 -18 -18 -18 -18 -18 -18 -18 -18 -18 -18 -18 -18 -20 -20 -20 -20 -25 0 0 0 0 -24 -21 -21 -21 -21 -21 -21 -21 -21 -21 -21 -25 0 0 0 0 0 0 0 0 0 0 0 0 0 0 0 0 0 0 0 0 0 0 0 0 0 0 0 0 0 0 -24 -18 -18 -19 -18 -19 -19 -19 -18 -18 -18 -18 -18 -18 -41 -41 -18 -18 -18 -18 -19 -18 -19 -18 -18 -18 -19 -18 -18 -18 -25 0 0 0 0 0 0 0 0 0 0 0 0 0 0 0 0 0 0 0 0
-24 -18 -18 -18 -18 -18 -18 -18 -18 -18 -18 -18 -18 -18 -18 -18 -18 -18 -18 -18 -18 -18 -18 -20 -20 -20 -20 -18 -18 -18 -18 -18 -18 -18 -18 -18 -18 -18 -20 -20 -20 -20 -20 -20 -20 -25 0 0 0 0 -24 -18 -18 -18 -18 -18 -18 -18 -18 -18 -18 -25 0 0 0 0 0 0 0 0 0 0 0 0 0 0 0 0 0 0 0 0 0 0 0 0 0 0 0 0 0 0 -24 -18 -18 -19 -18 -19 -19 -19 -18 -18 -18 -18 -18 -18 -32 -41 -18 -18 -18 -18 -19 -18 -19 -18 -18 -18 -19 -18 -18 -18 -25 0 0 0 0 0 0 0 0 0 0 0 0 0 0 0 0 0 0 0 0
-24 -21 -21 -21 -21 -21 -21 -21 -21 -21 -21 -21 -21 -21 -21 -21 -21 -21 -21 -21 -21 -21 -21 -21 -21 -21 -21 -21 -21 -21 -21 -21 -21 -21 -21 -21 -21 -21 -21 -21 -21 -21 -21 -21 -21 -25 0 0 0 0 -24 -18 -18 -18 -18 -18 -18 -18 -18 -18 -18 -25 0 0 0 0 0 0 0 0 -24 -21 -21 -21 -21 -21 -21 -21 -21 -21 -21 -25 0 0 0 0 0 0 0 0 0 0 -24 -18 -18 -19 -18 -19 -19 -19 -18 -18 -18 -18 -18 -18 -28 -45 -18 -18 -18 -18 -18 -19 -20 -20 -20 -18 -18 -18 -18 -18 -25 0 0 0 0 0 0 0 0 0 0 0 0 0 0 0 0 0 0 0 0
0 0 0 0 0 0 0 0 0 0 0 0 0 0 0 0 0 0 0 0 0 0 0 0 0 0 0 0 0 0 0 0 0 0 0 0 0 0 0 0 0 0 0 0 0 0 0 0 0 0 -24 -18 -18 -18 -18 -45 -18 -18 -18 -18 -18 -25 0 0 0 0 0 0 0 0 -24 -41 -45 -18 -18 -18 -18 -18 -18 -18 -45 -25 0 0 0 0 0 0 0 0 0 0 -24 -18 -18 -19 -18 -19 -19 -19 -19 -18 -18 -18 -18 -18 -28 -45 -18 -18 -18 -18 -18 -20 -20 -32 -20 -20 -18 -18 -18 -18 -25 0 0 0 0 0 0 0 0 0 0 0 0 0 0 0 0 0 0 0 0
0 0 0 0 0 0 0 0 0 0 0 0 0 0 0 0 0 0 0 0 0 0 0 0 0 0 0 0 0 0 0 0 0 0 0 0 0 0 0 0 0 0 0 0 0 0 0 0 0 0 -24 -18 -18 -18 -18 -45 -18 -18 -18 -18 -18 -25 0 0 0 0 0 0 0 0 -24 -18 -18 -18 -18 -18 -18 -18 -36 -34 -18 -23 -23 -23 -23 -23 -23 -23 -23 -23 -23 -23 -21 -18 -18 -18 -18 -19 -19 -18 -19 -18 -18 -18 -18 -18 -31 -45 -18 -18 -18 -18 -18 -20 -30 -26 -29 -20 -18 -18 -18 -18 -25 0 0 0 0 0 0 0 0 0 0 0 0 0 0 0 0 0 0 0 0
0 0 0 0 0 0 0 0 0 0 0 0 0 0 0 0 0 0 0 0 0 0 0 0 0 0 0 0 0 0 0 0 0 0 0 0 0 0 0 0 0 0 0 0 0 0 0 0 0 0 -24 -18 -18 -18 -18 -45 -18 -18 -18 -18 -18 -25 0 0 0 0 0 0 0 0 -24 -18 -18 -18 -18 -18 -18 -18 -35 -33 -18 -18 -18 -18 -18 -18 -18 -18 -18 -18 -18 -18 -18 -18 -18 -18 -18 -19 -19 -18 -18 -18 -18 -18 -18 -18 -45 -45 -18 -18 -18 -18 -18 -20 -20 -28 -20 -20 -18 -18 -18 -18 -25 0 0 0 0 0 0 0 0 0 0 0 0 0 0 0 0 0 0 0 0
0 0 0 0 0 0 0 0 0 0 0 0 0 0 0 0 0 0 0 0 0 0 0 0 0 0 0 0 0 0 0 0 0 0 0 0 0 0 0 0 0 0 0 0 0 0 0 0 0 0 -24 -18 -18 -18 -18 -45 -45 -18 -18 -20 -20 -21 -21 -21 -21 -21 -21 -21 -21 -21 -21 -18 -18 -18 -18 -18 -18 -18 -18 -18 -18 -18 -18 -18 -18 -18 -18 -18 -18 -18 -18 -18 -18 -18 -18 -18 -18 -18 -18 -18 -18 -18 -18 -18 -18 -18 -45 -45 -18 -18 -18 -18 -18 -18 -20 -28 -20 -18 -18 -18 -18 -18 -25 0 0 0 0 0 0 0 0 0 0 0 0 0 0 0 0 0 0 0 0
0 0 0 0 0 0 0 0 0 0 0 0 0 0 0 0 0 0 0 0 0 0 0 0 0 0 0 0 0 0 0 0 0 0 0 0 0 0 0 0 0 0 0 0 0 0 0 0 0 0 -24 -18 -18 -18 -18 -18 -18 -18 -20 -18 -20 -20 -18 -18 -18 -36 -34 -18 -18 -18 -18 -18 -18 -18 -18 -18 -18 -18 -18 -18 -18 -18 -18 -18 -18 -18 -18 -18 -18 -18 -18 -18 -18 -18 -18 -18 -18 -18 -18 -18 -19 -18 -18 -18 -18 -18 -41 -45 -18 -18 -18 -18 -18 -18 -20 -28 -20 -18 -18 -18 -18 -18 -25 0 0 0 0 0 0 0 0 0 0 0 0 0 0 0 0 0 0 0 0
0 0 0 0 0 0 0 0 0 0 0 0 0 0 0 0 0 0 0 0 0 0 0 0 -24 -42 -42 -42 -42 -42 -42 -42 -42 -42 -42 -25 0 0 0 0 0 0 0 0 0 0 0 0 0 0 -24 -18 -18 -18 -18 -18 -18 -18 -18 -18 -20 -18 -18 -18 -18 -35 -33 -18 -18 -18 -18 -18 -18 -18 -18 -18 -18 -18 -18 -18 -18 -18 -18 -18 -18 -18 -18 -18 -18 -18 -18 -18 -18 -18 -18 -18 -18 -18 -18 -18 -19 -18 -18 -18 -18 -18 -45 -45 -18 -18 -18 -18 -18 -18 -20 -31 -20 -18 -18 -18 -18 -18 -25 0 0 0 0 0 0 0 0 0 0 0 0 0 0 0 0 0 0 0 0
0 0 0 0 0 0 0 0 0 0 0 0 0 0 0 0 0 0 0 0 0 0 0 0 -24 -20 -20 -20 -20 -20 -20 -20 -20 -20 -20 -25 0 0 0 0 0 0 0 0 -24 -21 -21 -21 -21 -21 -21 -18 -18 -18 -18 -18 -18 -18 -18 -20 -20 -20 -18 -18 -18 -18 -18 -18 -18 -18 -18 -18 -36 -34 -18 -18 -18 -18 -18 -18 -18 -47 -23 -23 -23 -23 -23 -23 -23 -23 -23 -23 -21 -18 -18 -18 -18 -18 -18 -18 -19 -18 -18 -18 -18 -18 -45 -32 -18 -18 -18 -18 -18 -18 -20 -20 -20 -18 -18 -18 -18 -18 -25 0 0 0 0 0 0 0 0 0 0 0 0 0 0 0 0 0 0 0 0
0 0 0 0 0 0 0 0 0 0 0 0 0 0 0 0 0 0 0 0 0 0 0 0 -24 -20 -20 -20 -20 -20 -20 -20 -20 -20 -20 -25 0 0 0 0 0 0 0 0 -24 -18 -18 -18 -18 -18 -18 -18 -18 -18 -18 -47 -21 -21 -21 -21 -46 -18 -20 -18 -18 -18 -18 -18 -18 -18 -18 -18 -35 -33 -18 -18 -18 -18 -18 -18 -41 -25 0 0 0 0 0 0 0 0 0 0 -24 -18 -18 -18 -18 -18 -18 -18 -19 -18 -18 -18 -18 -18 -45 -28 -18 -18 -18 -18 -18 -18 -19 -18 -18 -18 -18 -18 -18 -18 -25 0 0 0 0 0 0 0 0 0 0 0 0 0 0 0 0 0 0 0 0
0 0 0 0 0 0 0 0 0 0 0 0 0 0 0 0 0 0 0 0 0 0 0 0 -24 -20 -20 -20 -20 -20 -20 -20 -20 -20 -20 -25 0 0 0 0 0 0 0 0 -24 -18 -18 -18 -18 -18 -18 -18 -18 -18 -18 -25 0 0 0 0 -24 -18 -18 -18 -18 -18 -18 -18 -18 -18 -18 -18 -18 -18 -18 -18 -18 -18 -18 -41 -41 -25 0 0 0 0 0 0 0 0 0 0 -24 -18 -18 -18 -18 -18 -18 -18 -19 -18 -18 -18 -18 -18 -41 -28 -18 -18 -18 -18 -18 -18 -19 -18 -18 -18 -18 -18 -18 -18 -25 0 0 0 0 0 0 0 0 0 0 0 0 0 0 0 0 0 0 0 0
0 0 0 0 0 0 0 0 0 0 0 0 0 0 0 0 0 0 0 0 0 0 0 0 -24 -20 -20 -20 -20 -20 -20 -20 -20 -20 -20 -25 0 0 0 0 0 0 0 0 -24 -18 -18 -18 -26 -18 -18 -26 -18 -18 -18 -25 0 0 0 0 -24 -18 -18 -18 -18 -18 -18 -18 -18 -18 -18 -47 -21 -21 -21 -21 -21 -21 -21 -21 -21 -25 0 0 0 0 0 0 0 0 0 0 -24 -18 -18 -18 -18 -18 -18 -19 -19 -18 -18 -18 -18 -18 -41 -31 -18 -18 -18 -18 -18 -19 -18 -18 -18 -18 -18 -18 -18 -18 -25 0 0 0 0 0 0 0 0 0 0 0 0 0 0 0 0 0 0 0 0
0 0 0 0 0 0 0 0 0 0 0 0 0 0 0 0 0 0 0 0 0 0 0 0 -24 -20 -20 -20 -20 -20 -20 -20 -20 -20 -20 -25 0 0 0 0 0 0 0 0 -24 -18 -18 -18 -18 -18 -18 -18 -18 -18 -18 -25 0 0 0 0 -24 -36 -34 -18 -18 -18 -18 -18 -18 -36 -34 -25 0 0 0 0 0 0 0 0 0 0 0 0 0 0 0 0 0 0 0 0 -24 -27 -27 -27 -34 -18 -18 -18 -18 -18 -18 -18 -18 -18 -18 -18 -18 -18 -18 -18 -18 -19 -18 -18 -18 -18 -36 -27 -27 -27 -25 0 0 0 0 0 0 0 0 0 0 0 0 0 0 0 0 0 0 0 0
0 0 0 0 0 0 0 0 0 0 0 0 0 0 0 0 0 0 0 0 0 0 0 0 -24 -20 -20 -20 -20 -20 -20 -20 -20 -20 -20 -21 -21 -21 -21 -21 -21 -21 -21 -21 -21 -18 -18 -32 -18 -18 -18 -18 -32 -18 -18 -25 0 0 0 0 -24 -35 -33 -18 -18 -18 -18 -18 -18 -35 -33 -25 0 0 0 0 0 0 0 0 0 0 0 0 0 0 0 0 0 0 0 0 -24 -41 -45 -41 -28 -18 -18 -18 -18 -18 -18 -18 -18 -18 -18 -18 -18 -18 -18 -19 -19 -19 -18 -18 -18 -18 -28 -45 -41 -45 -25 0 0 0 0 0 0 0 0 0 0 0 0 0 0 0 0 0 0 0 0
0 0 0 0 0 0 0 0 0 0 0 0 0 0 0 0 0 0 0 0 0 0 0 0 -24 -20 -20 -20 -20 -20 -20 -20 -20 -20 -20 -20 -18 -20 -18 -18 -18 -18 -18 -18 -18 -18 -18 -35 -27 -27 -27 -27 -33 -18 -18 -25 0 0 0 0 -24 -18 -18 -18 -18 -18 -18 -18 -18 -18 -18 -22 -22 -22 -22 -22 -25 0 0 0 0 0 0 0 0 0 0 0 0 0 0 0 -24 -45 -41 -45 -28 -18 -18 -18 -18 -18 -18 -18 -19 -19 -19 -19 -19 -19 -19 -19 -18 -18 -18 -18 -18 -18 -28 -41 -45 -41 -25 0 0 0 0 0 0 0 0 0 0 0 0 0 0 0 0 0 0 0 0
0 0 0 0 0 0 0 0 0 0 0 0 0 0 0 0 0 0 0 0 0 0 0 0 -24 -20 -20 -20 -20 -20 -20 -20 -20 -20 -20 -20 -20 -18 -18 -18 -18 -18 -18 -18 -18 -18 -18 -18 -18 -18 -18 -18 -18 -18 -18 -25 0 0 0 0 -24 -21 -21 -21 -21 -46 -18 -18 -18 -18 -18 -44 -44 -18 -41 -41 -25 0 0 0 0 0 0 0 0 0 0 0 0 0 0 0 -24 -41 -45 -41 -28 -18 -18 -18 -18 -18 -18 -18 -18 -18 -18 -18 -18 -18 -18 -18 -18 -18 -18 -18 -18 -18 -28 -45 -41 -45 -25 0 0 0 0 0 0 0 0 0 0 0 0 0 0 0 0 0 0 0 0
0 0 0 0 0 0 0 0 0 0 0 0 0 0 0 0 0 0 0 0 0 0 0 0 -24 -20 -20 -20 -20 -20 -20 -20 -20 -20 -20 -20 -18 -20 -26 -18 -18 -26 -18 -18 -18 -18 -18 -18 -18 -18 -18 -18 -18 -18 -18 -25 0 0 0 0 0 0 0 0 0 -24 -18 -18 -18 -18 -18 -18 -18 -18 -18 -41 -25 0 0 0 0 0 0 0 0 0 0 0 0 0 0 0 -24 -21 -21 -21 -21 -21 -21 -21 -21 -21 -21 -21 -21 -21 -21 -21 -21 -21 -21 -21 -21 -21 -21 -21 -21 -21 -21 -21 -21 -21 -25 0 0 0 0 0 0 0 0 0 0 0 0 0 0 0 0 0 0 0 0
0 0 0 0 0 0 0 0 0 0 0 0 0 0 0 0 0 0 0 0 0 0 0 0 -24 -20 -20 -20 -20 -20 -20 -20 -20 -20 -20 -20 -18 -18 -18 -18 -18 -18 -18 -18 -18 -18 -18 -18 -18 -18 -18 -18 -18 -18 -18 -25 0 0 0 0 0 0 0 0 0 -24 -18 -18 -43 -18 -18 -18 -18 -18 -18 -18 -25 0 0 0 0 0 0 0 0 0 0 0 0 0 0 0 0 0 0 0 0 0 0 0 0 0 0 0 0 0 0 0 0 0 0 0 0 0 0 0 0 0 0 0 0 0 0 0 0 0 0 0 0 0 0 0 0 0 0 0 0 0 0 0 0 0 0
0 0 0 0 0 0 0 0 0 0 0 0 0 0 0 0 0 0 0 0 0 0 0 0 -24 -21 -21 -21 -21 -21 -21 -21 -21 -21 -46 -18 -20 -18 -18 -18 -18 -18 -18 -18 -18 -47 -21 -21 -21 -21 -21 -21 -21 -21 -21 -25 0 0 0 0 0 0 0 0 0 -24 -18 -18 -18 -43 -41 -41 -18 -18 -18 -18 -25 0 0 0 0 0 0 0 0 0 0 0 0 0 0 0 0 0 0 0 0 0 0 0 0 0 0 0 0 0 0 0 0 0 0 0 0 0 0 0 0 0 0 0 0 0 0 0 0 0 0 0 0 0 0 0 0 0 0 0 0 0 0 0 0 0 0
0 0 0 0 0 0 0 0 0 0 0 0 0 0 0 0 0 0 0 0 0 0 0 0 0 0 0 0 0 0 0 0 0 0 -24 -18 -18 -36 -27 -27 -27 -27 -34 -18 -18 -25 0 0 0 0 0 0 0 0 0 0 0 0 0 0 0 0 0 0 0 -24 -18 -18 -18 -41 -41 -41 -41 -18 -18 -18 -25 0 0 0 0 0 0 0 0 0 0 0 0 0 0 0 0 0 0 0 0 0 0 0 0 0 0 0 0 0 0 0 0 0 0 0 0 0 0 0 0 0 0 0 0 0 0 0 0 0 0 0 0 0 0 0 0 0 0 0 0 0 0 0 0 0 0
0 0 0 0 0 0 0 0 0 0 0 0 0 0 0 0 0 0 0 0 0 0 0 0 0 0 0 0 0 0 0 0 0 0 -24 -18 -18 -31 -18 -18 -18 -18 -31 -18 -18 -25 0 0 0 0 0 0 0 0 0 0 0 0 0 0 0 0 0 0 0 -24 -18 -18 -18 -18 -41 -41 -44 -18 -18 -18 -25 0 0 0 0 0 0 0 0 0 0 0 0 0 0 0 0 0 0 0 0 0 0 0 0 0 0 0 0 0 0 0 0 0 0 0 0 0 0 0 0 0 0 0 0 0 0 0 0 0 0 0 0 0 0 0 0 0 0 0 0 0 0 0 0 0 0
0 0 0 0 0 0 0 0 0 0 0 0 0 0 0 0 0 0 0 0 0 0 0 0 0 0 0 0 0 0 0 0 0 0 -24 -18 -18 -18 -18 -18 -18 -18 -18 -18 -18 -25 0 0 0 0 0 0 0 0 0 0 0 0 0 0 0 0 0 0 0 -24 -43 -18 -18 -18 -18 -18 -18 -18 -18 -18 -25 0 0 0 0 0 0 0 0 0 0 0 0 0 0 0 0 0 0 0 0 0 0 0 0 0 0 0 0 0 0 0 0 0 0 0 0 0 0 0 0 0 0 0 0 0 0 0 0 0 0 0 0 0 0 0 0 0 0 0 0 0 0 0 0 0 0
0 0 0 0 0 0 0 0 0 0 0 0 0 0 0 0 0 0 0 0 0 0 0 0 0 0 0 0 0 0 0 0 0 0 -24 -18 -18 -18 -18 -18 -18 -18 -18 -18 -18 -25 0 0 0 0 0 0 0 0 0 0 0 0 0 0 0 0 0 0 0 -24 -41 -43 -18 -18 -18 -18 -18 -18 -43 -41 -25 0 0 0 0 0 0 0 0 0 0 0 0 0 0 0 0 0 0 0 0 0 0 0 0 0 0 0 0 0 0 0 0 0 0 0 0 0 0 0 0 0 0 0 0 0 0 0 0 0 0 0 0 0 0 0 0 0 0 0 0 0 0 0 0 0 0
0 0 0 0 0 0 0 0 0 0 0 0 0 0 0 0 0 0 0 0 0 0 0 0 0 0 0 0 0 0 0 0 0 0 -24 -21 -21 -21 -21 -21 -21 -21 -21 -21 -21 -25 0 0 0 0 0 0 0 0 0 0 0 0 0 0 0 0 0 0 0 -24 -41 -41 -43 -18 -18 -18 -18 -18 -41 -41 -25 0 0 0 0 0 0 0 0 0 0 0 0 0 0 0 0 0 0 0 0 0 0 0 0 0 0 0 0 0 0 0 0 0 0 0 0 0 0 0 0 0 0 0 0 0 0 0 0 0 0 0 0 0 0 0 0 0 0 0 0 0 0 0 0 0 0
0 0 0 0 0 0 0 0 0 0 0 0 0 0 0 0 0 0 0 0 0 0 0 0 0 0 0 0 0 0 0 0 0 0 0 0 0 0 0 0 0 0 0 0 0 0 0 0 0 0 0 0 0 0 0 0 0 0 0 0 0 0 0 0 0 -24 -21 -21 -21 -21 -21 -21 -21 -21 -21 -21 -25 0 0 0 0 0 0 0 0 0 0 0 0 0 0 0 0 0 0 0 0 0 0 0 0 0 0 0 0 0 0 0 0 0 0 0 0 0 0 0 0 0 0 0 0 0 0 0 0 0 0 0 0 0 0 0 0 0 0 0 0 0 0 0 0 0 0
0 0 0 0 0 0 0 0 0 0 0 0 0 0 0 0 0 0 0 0 0 0 0 0 0 0 0 0 0 0 0 0 0 0 0 0 0 0 0 0 0 0 0 0 0 0 0 0 0 0 0 0 0 0 0 0 0 0 0 0 0 0 0 0 0 0 0 0 0 0 0 0 0 0 0 0 0 0 0 0 0 0 0 0 0 0 0 0 0 0 0 0 0 0 0 0 0 0 0 0 0 0 0 0 0 0 0 0 0 0 0 0 0 0 0 0 0 0 0 0 0 0 0 0 0 0 0 0 0 0 0 0 0 0 0 0 0 0 0 0 0 0 0
0 0 0 0 0 0 0 0 0 0 0 0 0 0 0 0 0 0 0 0 0 0 0 0 0 0 0 0 0 0 0 0 0 0 0 0 0 0 0 0 0 0 0 0 0 0 0 0 0 0 0 0 0 0 0 0 0 0 0 0 0 0 0 0 0 0 0 0 0 0 0 0 0 0 0 0 0 0 0 0 0 0 0 0 0 0 0 0 0 0 0 0 0 0 0 0 0 0 0 0 0 0 0 0 0 0 0 0 0 0 0 0 0 0 0 0 0 0 0 0 0 0 0 0 0 0 0 0 0 0 0 0 0 0 0 0 0 0 0 0 0 0 0
0 0 0 0 0 0 0 0 0 0 0 0 0 0 0 0 0 0 0 0 0 0 0 0 0 0 0 0 0 0 0 0 0 0 0 0 0 0 0 0 0 0 0 0 0 0 0 0 0 0 0 0 0 0 0 0 0 0 0 0 0 0 0 0 0 0 0 0 0 0 0 0 0 0 0 0 0 0 0 0 0 0 0 0 0 0 0 0 0 0 0 0 0 0 0 0 0 0 0 0 0 0 0 0 0 0 0 0 0 0 0 0 0 0 0 0 0 0 0 0 0 0 0 0 0 0 0 0 0 0 0 0 0 0 0 0 0 0 0 0 0 0 0